Una sera... andarono all'assalto: Al ritmo ansioso dell'attesa, proprio del capitolo precedente, si sostituisce qui, con l'arrivo di Lucia, quello lieto della speranza realizzata. Il passaggio è evidenziato, secondo il punto di vista di Renzo, con la similitudine dei cavalli dapprima impazienti e quindi lanciati in corsa (28-33). Nel capitolo IV erano stati gli occhi del padre Cristoforo a essere paragonati a due cavalli bizzarri (59). Infatti il ricordo del frate domina questa pagina, poiché, se la similitudine rimanda alla sua prima apparizione, l’invito di Lucia a pregare per lui riecheggia le sue ultime parole rivolte a Renzo: a tutti quelli che rimangono, e si ricordano di fra Cristoforo, dì che preghin per lui (XXXVI, 737-40). Nel dialogo tra Renzo e don Abbondio si noti, in rapporto ai due dialoghi del capitolo II, l'immobilità psicologica del curato, sostanzialmente fermo sulle stesse posizione assunte all'inizio della storia, contrapposta al mutato atteggiamento di Renzo, non più rabbioso e disarmato di fronte agli ostacoli, ma sicuro di sé e addirittura pronto a una bonaria ironia (le è poi passato quel dolor di capo..., 48). L'opposizione tra i due (vedi nota generale a XXIX, 1-364) si farà più esplicita alla fine del capitolo, quando Renzo sciorinerà il rosario dei suoi ho imparato (621 sgg.), mentre don  Abbondio sta dimostrando qui di non avere imparato proprio niente. Sia nelle battute di dialogo, sia nelle poche didascalie d’autore l’orditura sintattica è rapida, scorrevole, «di corto respiro» (Nencioni, Leggere PS), cioè caratterizzata da periodi brevi e incalzanti, che riproducono con grande precisione l'andamento spezzato della comunicazione orale. Sono significativi in questo senso alcuni passaggi dalla ventisettana all’edizione definitiva che sostituiscono a espressioni letterarie o tipiche della lingua scritta altre più colorite e vivaci: egli capiva benissimo che cosa si dovesse sottintendere a quelle parole diventa lui intendeva bene che quelle parole non esprimevan tutto ciò che passava nel cuore di Lucia (14-16); per qualunque soggetto si passasse diventava di qualunque cosa si parlasse (27); Non già che don Abbondio rispondesse di non volere diventa Don Abbondio non disse di no (51-52). Sono inoltre riconoscibili in filigrana, come spesso accade nei discorsi dei personaggi popolari, modi di dire del dialetto milanese: far la tara (14) da dagh la tara, ci faceva dentro (36) da vessegh dent; mutria (77) da motria.
Son qui loro... e poi se n'ando: Il secondo dialogo che ha per protagonista don Abbondio si divide nettamente in due momenti: prima di sapere della morte di don Rodrigo il curato temporeggia, impiegando la stessa tattica già adottata all’inizio del romanzo; dopo la notizia liberatrice dà sfogo a esplosioni di gioia e annuncia piena disponibilità a celebrare il matrimonio. Il serpeggiare (115) di don Abbondio ricorda un altro personaggio che evoca l'immagine della serpe per il proprio comportamento astuto e sfuggente: Antonio Ferrer che, nel capitolo XIII, si insinua nella casa del vicario ritirando entro la porta anche lo strascico, che disparve come la coda d’una serpe (451-52). L’accostamento al mondo animale non è nuovo per don Abbondio: nel capitolo VI Agnese lo definiva lesto come un gatto (368). I gran mirallegri (108) erano, nella ventisettana, con minor colore e originalità, dei gran mi rallegro. La fusione di una breve frase in una sola parola era già comparsa col lascifareame pronunciato da don Rodrigo (XI, 48). Il serpeggiare (115) di don Abbondio è frutto di una correzione sul precedente tergiversare: «Il tergiversare è ancora troppo solenne, e da uomo di politica alta; il serpeggiare invece dice tutti i piccoli volteggiamenti d’una nervatura avvezza da un pezzo alla prudenza e alla duttilità delle serpi» (Petrocchi 1902).
Ah! e morto... parlar di bubbole: Lo sfogo di don Abbondio ha qualcosa di blasfemo: tra gli interpreti, Attilio Momigliano ha parlato di «Te Deum per una strage», Getto (1964) di «inno alla Provvidenza, che grottescamente finisce per trasformarsi in un inno alla peste». Per il curato insomma, come nota Pampaloni (1988), la vita «è un privilegio». Chi lo infastidiva è morto e, di fronte a questa rassicurante certezza, don Abbondio passa, nei confronti di don Rodrigo, dal servo encomio al codardo oltraggio (le due espressioni sono quelle usate dal Manzoni nell'ode Il 5 maggio). L’uscita di scena del tiranno asseconda infatti il suo «egoismo fisiologico del tutto privo di carità. La vita ultraterrena, perdono o condanna, Dio stesso, sono assenti nella sua coscienza, nella sua gioia animale di sopravvissuto» (Pampaloni 1988). Spinto da incontenibile allegria don Abbondio parla a ruota libera, passando dal sollievo per la morte di don Rodrigo al nuovo titolo dei cardinali, dall'epidemia matrimoniale che sembra diffondersi tra i suoi parrocchiani dopo lo scampato pericolo alla ricapitolazione dei  guai passati. Non solo il rincorrersi degli argomenti, ma anche la creatività linguistica del curato rendono scoppiettante il ritmo della pagina. Si notino, nel discorso, alcune vivacissime forme metaforiche: la terna di aggettivi verdi, freschi, prosperosi (167-68), che si riferisce al prosperare dei prepotenti come a un fenomeno di rigoglio vegetale; il verbo lo succiano (214), che suggerisce, con espressiva volgarità, il piacere fisico, simile a quello del cibo, che la vanità soddisfatta procura (la ventisettana aveva succiano su, forma ancora più colorita perché il su è un lombardismo). Tra le espressioni che riecheggiano modelli dialettali: vi tenga di mira (185), collegabile a una forma usata dal Porta, me tujess de mira; vi dico in chiesa (190) da di' giò in gesa; tirar la carretta (222-23) da tirà el carr; mosconi (245) da moscon; sono alle ventitrè e tre quarti (256-57) da vess sui vinti tré or e mezza. Non è don Abbondio a smettere di parlare, ma il narratore a togliergli la parola (saremmo ancor ben lontani dalla fine, se volessimo riferir tutto il rimanente di que' discorsi, 288-89). Negli ultimi due capitoli si verificano, oltre a questo, quattro casi di preterizione (vedi in proposito la nota a XXXVII, 207-279), dove la voce narrante afferma di non volersi soffermare più a lungo su un argomento (XXXVII, 254-57, 307-08 e 394-400; XXXVIII, 611-12). E il sipario cala sempre su discorsi o vicende di vita minuta dei protagonisti: «l'autore si comporta svelatamente come l'arbitro di un gioco, come il burattinaio dei suoi personaggi: li vede dall'alto e dall'alto li manovra; gli dà e gli leva la parola, e si sostituisce a loro con impazienza o fastidio, quando toccano, nella loro più trita modestia, il minimo di accettabilità. Ma al disotto di quel limite sta appunto, per i suoi  lettori (lettori di un romanzo!), la  futura quotidianità, normale e serena, dei promessi finalmente sposi» (Nencioni, Leggere PS). Il decreto grazioso (187) è l’amnistia concessa il 30 gennaio 1630 per la nascita del principe Carlo, primogenito di Filippo IV. Il papa che ha cambiato il titolo dei cardinali (208-10 sgg.) è Urbano VII, già comparso nei capitoli XIX e XXVII. La frase latina sfoggiata dal curato (259) proviene da una commedia di Terenzio, autore di teatro vissuto a Roma nel II secolo a.C., e si ritrova anche nel De senectute, trattato sulla vecchiaia di Cicerone. 
Il giorno seguente... ma guarire, ve': Le parole di don Abbondio registrano la presenza di altre forme metaforiche. Nel romanzo manzoniano le metafore non sono molto frequenti, e, soprattutto, l’autore non mira a creare imaggini che suscitino meraviglia e stupore, ma piuttosto a collegare tra loro oggetti e situazioni quotidiani, che l'accostamento illumina di nuova luce. Inoltre nei Promessi sposi si preferiscono le metafore istituzionali, diventate, per frequenza d'uso, patrimonio comune alla maggioranza dei parlanti. Tale atteggiamento, che ribadisce ancora una volta la scelta di proporre una lingua compresibile a un vasto numero di lettori, può essere verificato anche nelle battute di don Abbondio. Due metafore relative alla vendita dei beni di Renzo e Lucia sono andare in bocca di qualche furbo (332-33) e fa all'amore a quelle quattro braccia di terra (333-34), la prima immagine proviene dal mondo degli animali, la seconda dall’area del desiderio erotico. L'una è l'altra figura suggeriscono dunque situazioni che appartengono all’esperienza collettiva di ogni giorno (lo stesso valeva per le due metafore analizzate alla nota precedente). Vendere per un pezzo di pane (336) e Gli hanno fatto fuoco (374) sono forme tanto comuni da avere addirittura perso, nella percezione di chi parla, il loro originario valore metaforico. Infine La carità più fiorita (338-39) non è in effetti una originale immagine poetica coniata dal curato, ma un modo di dire popolare sia  milanese sia fiorentino (registrato nel Cherubini, e annotato dal Manzoni nelle sue postille al vocabolario della Crusca). L'animazione degli oggetti all'ingresso del marchese in casa di Lucia (384-87) è una forma di iperbole: lo stupore è tanto da trasferirsi addirittura nelle cose, che, potendo parlare, lo esprimerebbero al pari delle persone. Un altro caso di oggetti parlanti era nel capitolo XIV, dove i denari usati per il gioco all'osteria della luna piena avrebbero dichiarato la loro illecita provenienza se avessero avuto il dono della parola (201-07). 
Venne la dispensa... imbroglian gli affetti: Alla gioia delle nozze si intrecciano sfumati segnali di malinconia, primo fra tutti il ricordo di fra Cristoforo, la cui figura, pur assente, ha occupato l'intero capitolo: non solo infatti Renzo e Lucia hanno pensato a lui incontrandosi (22 sgg.), ma le parole di perdono pronunciate da Renzo nei confronti di don Rodrigo (178) derivano direttamente dai suoi insegnamenti, al punto che non sono in effetti l’atteggiamento di Renzo e quello di don Abbondio a contrapporsi, ma «è come se per un attimo si trovassero di fronte la morale di padre Cristoforo e il codice di don Abbondio» (Raimondi 1974). Un'altra presenza incombente è quella della recente pestilenza col suo carico di  morti, richiamata dal cimitero di Canterelli, e dalla scomparsa di un altro personaggio intrecciato con la storia degli sposi, l'Azzecca-garbugli, l'ultima vittima della peste di cui il romanzo dia notizia. Anche la festa al palazzo del marchese è un trionfo non completamente realizzato: il ritorno della dimensione quotidiana porta con sé una prevalenza di aspetti positivi, che sono però imperfetti, mai grandiosi: sotto l’apparente letizia si insinua insomma una nota amara. Le riflessioni di Renzo indeciso tra agricoltura e industria (450-51) alludoni (e l'ironico paragone con le accademie del secolo passato, 452, lo prova) alle dispute settecentesche tra i fautori di un sistema economico mercantilistico, basato sull'industria, e i sostenitori dell'agricoltura, o fisiocratici. Renzo, fino ad allora operaio (filatore di seta) e contadino insieme, deve prendere una decisione che riflette un capitolo di storia sociale ed economica. E la sua scelta lo porterà a un avanzamento sociale, trasformandolo in un piccolo imprenditore borghese.
Chi domandasse... gran male: Nuove tristezze derivano dal distacco dalle persone care e dal paese. Ricorrono sostantivi come lacrime (460; 462) e dolore (469; 471); aggettivi come amari (480); triste (481); aspro e pungente (484). È questo il secondo distacco dei tre personaggi dal paese natale, dopo quello a conclusione del capitolo VIII, sottolineato dall’addio ai monti di Lucia. Il rapporto tra i due momenti è esplicitamente suggerito (si pensi solo al ricorrere del sostantivo montagne, 470, anche in questo punto), ma la situazione risulta ora ben diversa, come chiariscono le considerazioni del narratore e la similitudine dell’animo. L’ultimo capitolo del romanzo sta concludendo la sua opera di ritordinamento: censiti i vivi e i morti, chi resta viene collocato nella sua nicchia (luogo, condizione sociale, evoluzione del carattere), destinato a restare, nella memoria dei lettori, immobile nella posizione assunta in quest’ultima fotografia. Ma non  si tratta di un ritratto solenne. Al contrario, «un disegno ironico [...] aggredisce proprio la struttura del lieto fine, il codice della favola secondo cui tutti i conti debbono all’ultimo tornare» (Raimondi 1974). Lucia, che ha vissuto suo malgrado una storia romanzesca, non pare ai nuovi compaesani adatta al ruolo di principessa delle fiabe perché tutti i suoi caratteri fisici si rivelano opposti alle irreali attese dei curiosi: i neri e giovanili capelli (II, 452) avrebbero dovuto essere proprio d'oro (XXXVIII, 506); il viso capace di esprimere gioia temperata da un turbamento leggiero (II, 466-67) non esibisce gote proprio di rosa (XXXVIII, 506); la modesta bellezza (II, 464-65) non basta agli osservatori, che finiscono per trovarla brutta affatto (514). Dunque due ritratti si fronteggiano: quello della vera Lucia apparsa nel capitolo II il giorno fissato per le sue nozze, e quello della Lucia ideale, che accumula stereotipi di bellezza femminile romanzesca specularmente antitetici ai caratteri della protagonista. La contrapposizione tra i due ritratti ribadisce la novità della scelta manzoniana di rendere protagonista del suo romanzo non una principessa, ma una contadina, e le parole di Renzo (È una contadina! V’ho detto mai che v’avrei menato qui una principipessa?, 524-25) possono essere lette anche come una finale dichiarazione di poetica indirizzata dall’autore al lettore.
Ma si direbbe... profittarne anche loro: Si colloca qui l’ultima delle preterizioni distribuite nei due capitoli finali (vedi nota a 161-292): nonostante i piccoli intoppi quotidiani, la vita dei protagonisti scorre così lietamente uniforme che raccontarla annoierebbe il lettore (595-96): «Qui siamo giunti al silenzio dei personaggi e, quel che è più, del narratore; siamo giunti al grado zero della materia linguistica per esaurimento dei contenuti narrabili» (Nencioni, Leggere PS). Il tema economico occupa, nella conclusione del romanzo, uno spazio significativo: Renzo, prima indeciso tra agricoltura e industria, è spinto dalle circostanze a optare per l'industria, ed entra nel ceto dei nuovi borghesi imprenditori. Convertito alla mentalità dell’investimento, bada al profitto, rivelandosi più accorto amministratore del giovine scapestrato (548) esponente della classe degli antichi proprietari. Secondo un principio tipicamente manzoniano morale ed economia vengono dunque a coincidere nella figura del moderno imprenditore borghese, rappresentante di un rinnovato assetto sociale. «Sostanzialmente anticonservatrice se rapportata all'anno 1827, la sua scelta [...] si inscribe in quel processo di industrializzazione [...] che in un paese contadino coincide sempre all’inizio con la tendenza a diminuire il suo grado di arretratezza [...]. Il filatoio che passa in mani più produttive, uscite dalla campagna, è una figura dell'ammodernamento [...], della civiltà industriale che avanza» (Raimondi 1974). 
Il bello era... apposta: La struttura dell’ultimo capitolo ha già lasciato emergere le conclusioni del narratore, attento a evitare la caduta in un irreale lieto fine idillico attraverso un continuo confronto con i piccoli fastidi e le disillusioni della vita quotidiana. Tocca ora ai personaggi esprimere, come sanno, la morale di tutta la storia. Le parole infatti sono soprattutto quelle di Renzo e Lucia, di messe e domestiche; per esempio le grandi calamità pubbliche, le oppressioni e le persecuzioni, che l'a nonimo aveva chiamato luttuose Traggedie d'horrori, e Scene di malvaggità grandiosa (Introduzione, 19) diventano guai (634). Tuttavia, come evidenzia Nencioni (1993), lingua del narratore e lingua dei personaggi si fondono nella pagina finale, collaborando alla ricerca di un significato. Infatti, se condotta (641) appartiene al vocabolario di Renzo (che parla di buona condotta in XXXVI, 412-13), gli aggettivi cauta e innocente (641) non entrano nella competenza attiva degli sposi (le due parole non compaiono mai nei loro discorsi diretti), ma rimandano piuttosto alla voce del narratore. Più sottile il caso di dottrina (629), che ricorre altrove nel romanzo nei due significati principali di teoria, insieme dei dogmi e principi professati dalla Chiesa (in bocca al cardinale Federigo), e di catechismo (in bocca a Renzo). In questo caso dottrina unisce in sé il valore più alto di teoria, e appartiene al narratore, che se ne serve con sfumatura ironica; e di catechismo, che può appartenere a Lucia. Proseguendo su questa scia, è possibile distinguere non soltanto le parole del narratore da quelle dei personaggi, ma anche il discorso di Renzo da quello di Lucia. Lucia è infatti, tra i personaggi, quello meno legato alla realtà quotidiana, e anche tutti i suoi discorsi, sebbene semplici, tendono a evitare forme troppo popolari. Un'ultima parola significativa è sugo (646), che entra nel discorso del narratore, ma appartiene in effetti al lessico di Renzo (che l'ha usata due volte nel corso del romanzo), ed è  presente nei dialetti sia milanese sia fiorentino. Dunque prevale la parola dei personaggi, e gli interventi del narratore tendono a confondersi e ad adeguarsi al livello del parlato popolare. Tutto questo dimostra, anche dal punto di vista linguistico, che l'intera vicenda deve passare attraverso il giudizio dei protagonisti, e che la loro conclusione è quella che anche il narratore condivide, non benchè trovata da povera gente (644-45), ma forse proprio perchè trovata dai personaggi popolari (Nencioni 1993). Il congedo richiama quello degli attori di una commedia, o la formula di un cantastorie. Ma Delcorno Branca (1980) vi individua anche un significativo rimando alla chiusa  del romanzo settecentesco inglese Tom Jones di Fielding: «E ora, amico, prendo quest'occasione per farti tanti auguri. Se ti sono stato un compagno divertente, t'assicuro che questo era tutto ciò che desideravo; e se in qualche cosa t'ho offeso, non l'ho fatto apposta». A differenza di quanto accade in Fielding, nei Promessi sposi si sottolinea lo sdoppiamento di piani tra anonimo autore e narratore: ma qui le due voci (chi l'ha scritta [...]; chi l'ha raccomodata, 648-49) non sono distinte per contrasto di posizioni, come è spesso accaduto nel corso del romanzo, bensì accomunate nella rituale speranza di aver recato piacere al lettore. Sono significative alcune correzioni nel passaggio dalla ventisettana alla quarantana, che documentano l'attenzione dello  scrittore nel caratterizzare la lingua dei suoi protagonisti. Nel caso di Renzo gli interventi tendono a enfatizzare il lato espressivo e popolare delle sue frasi: per esempio ho imparato a non bere più del bisogno diventa ho imparato a non alzar troppo il gomito (624). Nel caso di Lucia la tendenza è opposta, perché viene cancellato il tratto più popolare delle sue parole: sono loro [i guai] che sono venuti a cercarmi me diventa son loro che sono venuti a cercar me (634-35).
far la tara: separare l'eccedenza dalla sostanza, valutare correttamente; 
ci faceva dentro molto bene: ci si trovava molto bene; 
concerti: accordi.
conca fessa: vaso incrinato, 
strisciò una bella riverenza: fece un bell'inchino; 
risicar: rischiare;
mutria: espressione accigliata;
lungagnata: faccenda che va per le lunghe; 
un pezzetto: per un po'; 
concertarsi: mettersi d'accordo.
tosta: sfrontata, ardita; 
alle velette: in guardia, di vedetta;
fidecommisso: disposizione legale per cui un erede era impegnato a non vendere in vita i beni ricevuti, e a lasciarli dopo la morte a persone determinate.
contorni: dintorni; 
l'esequie: servizio funebre; 
latinucci: i primi esercizi di latino; 
quell'albagìa: alterigia, superbia; 
con quel palo in corpo: con quel portamento rigido.
vi tenga di mira: vi perseguiti;
ha dato di bianco: ha cancellato; 
vi dico in chiesa: faccio le pubblicazioni matrimoniali; 
darne parte: informarne; 
accertare: assicurare; 
se lo succiano: lo succhiano, lo ricevono e se lo godono; 
proposti: prevosti;
gli avvezzin male: li abituino male; 
dispensa: esenzione; 
denunzie: pubblicazioni, avvisi pubblici di un prossimo matrimonio.
mosconi: spasimanti, 
un pezzo: molto tempo; 
hisenectus ipsa est morbus: la vecchiaia è di per se stessa una malattia.
nel buono: sul più bello, ritenendo: trattenendo; 
bubbole: argomenti vani; 
cura: parrocchia.
fa all'amore a: desidera vivamente; 
fatto loro: loro proprietà; 
compadrone: comproprietario, poiché il parroco riceveva dai parrocchiani parte delle decime, come il feudatario; 
inclinato: disposto, propenso.
alla carlona: in modo sconnesso e disordinato; 
impegni: incriminazioni; 
Gli hanno fatto fuoco addosso: lo hanno preso di mira; 
vox populi, vox Dei: la voce del popolo è voce di Dio; 
l'impannate: finestre senza vetri, con ante di panno; 
a tastoni: a tentoni, alla cieca; 
sproposito: esagerazione; 
l'istrumento: contratto; 
stare a patti: fare un accordo.
assolutoria: assoluzione della condanna subita da Renzo per i fatti di Milano; 
naturale: indole; 
tinello: corrispondente al milanese tinell, «luogo dove mangiano i servi o famigliari nelle case de' signori» (Cherubini).
grand'inciampi: ostacoli; 
avvezzi: abituati; 
l'agevolezze: agevolazioni; 
divezzarlo: svezzarlo; 
d'assenzio: liquore amarissimo.
rapportarono: riferirono, ne fu tocco: ne fu toccato, colpito;
trattasse: si comportasse.
sardonico: sarcastico, sprezzante; 
cagione: causa; 
deliberato: deciso; 
consumazioni: spese; 
grassi: favorevoli; 
baggiana: sempliciona, babbea; si tratta dell'apiteto ordinariamente attribuito dai bergamaschi ai milanesi, come spiegato nella nota a XVII, 520-594; 
lesto: svelto.
a un di presso: più o meno;
argani: strumenti per sollevare i pesi; 
d'incaglio: rallentamento, ostacolo; 
sviamento: disadattamento; 
pretensioni: pretese;
carico reale e personale: tassa, imposta sulla persona e sui beni.
governarsi: comportarsi; 
martello: battente; 
sproposito: sbaglio, follia; 
dato cagione: offerto un motivo, una causa.