Quantunque... tutto quello che si vede: Secondo un procedimento consueto nel romanzo, viene inquadrata dapprima la scena dall'alto, quindi il campo visuale si restringe a immagini più ravvicinate. In questo caso dapprima compaiono le due ali di folla che raggiungono, da direzioni opposte, il castello dell'innominato. Quindi, il corpo compatto della massa comincia a distinguersi in gruppi e correnti. Infine lo sguardo si posa sulle due donne e, per ultimo, sulla figura centrale di queste pagine, don Abbondio. Il curato è infastidito, in successione, da due circostanze. Primo: l’eccessiva quantità di rifugiati. Secondo: i preparativi militari che si svolgono al castello. E i suoi due fastidi sono introdotti entrambi dalla congiunzione avversativa Ma (16; 45), che sottolinea il contrasto tra situazioni oggettivamente positive (molte persone riunite insieme, con la possibilità di difendersi in caso di bisogno) e percezione distorta che di queste situazioni ha il personaggio. La voce del buon senso è incarnata da Agnese e Perpetua, che contraddicono gli argomenti del curato in frammenti di dialogo rapidi e vivaci. Messo alle strette dalla logica delle donne, don Abbondio le zittisce, e imbastisce frettolose ammonizioni sull'opportunità di parlare il meno possibile (Chetatevi un po’, — disse don Abbondio: — che già le chiacchiere non servono a nulla, 41-42; zitta! E badate bene di non riportare questi discorsi, 77-78). Nei discorsi di don Abbondio si alternano un registro lamentoso e un registro sentenzioso. Il primo è caratterizzato da esclamazioni (Oh povero me! risuona in queste pagine cinque volte: 25; 35; 51; 55; 71, più la variante ohimé, ohimè, 83), e da borbottamenti che si ripetono come una cantilena (e via, e via, e via, 38). Il secondo comprende frasi proverbiali, che condensano in poche battute succose sintesi della filosofia del curato. Un esempio di questo modo di parlare è l’opinione di don Abbondio sulla buona creanza: La creanza e di non dir le cose, posson dispiacere, specialmente a chi non e avvezzo a sentirne (108-109).
Alla Malanotte... prenderne il possesso: L'osteria della Malanotte è il luogo di questo capitolo dove si concentrano più fitti i ricordi del passato. Anche don Rodrigo, quando aveva fatto visita all'innominato per commissionargli il rapimento di Lucia, si era fermato alla Malanotte (XX, 43-68), lasciando lì cavallo e armi, come ora i fuggiaschi congedano la carrozza. Alla Malanotte si era fermata la carrozza con Lucia rapita, e qui la protagonista aveva incontrato la vecchia incaricata di riceverla (XXI, 5-16). E infine don Abbondio stesso era transitato, pieno di terrore, davanti alla Malanotte (XXIII, 648-49) poco prima della liberazione della protagonista. L'osteria segna insomma il confine, insieme reale e simbolico, tra il mondo esterno e il dominio dell’innominato, prima regno del delitto, ora della carità, ma, in entrambi i casi, diverso, per estremismo, dall'ambiente che lo circonda. Da un punto di vista linguistico, sì noti in queste righe l’ossimoro gridò sottovoce (119), che unisce due termini in contraddizione tra loro. Così commenta Petrocchi (1902): «il Manzoni voleva ritrarre quello sberciare che uno fa a bassa voce, all'orecchio d’uno, in cui è più l’atto che la voce stessa, ma l’impressione è identica, tanto ci mette d’intenzione». Nel passaggio dalla ventisettana alla quarantana è significativo, in queste pagine, il lavoro variantistico sul ricorrente imperativo Zitta che don Abbondio rivolge a Perpetua (63; 64, 77; 119; si aggiungano Volete stare zitta, 97 e State zitta, 102). In tutti questi casi, escluso quello alla riga 119, al posto del nome del predicato zitta si trovava, nella prima edizione, il verbo «tacere». Petrocchi (1902) spiega la sistematica sostituzione con il fatto che «tacere» dovette sembrare a Manzoni troppo letterario, e zitta più immediato. Ma, almeno in uno degli esempi, la variante elimina una forma chiaramente dialettale: State zitta (102) era infatti reso con un Tacete lì che ricalca chiaramente il dialetto milanese. La stessa volontà di tagliare un'espressione marcatamente dialettale si riconosce nella sostituzione del maschile 24410 (riferito a Perpetua) con zitta (119). La forma maschile usata anche in riferimento a un personaggio femminile è infatti tipica della parlata lombarda, e compare anche in altri punti della prima edizione, ma viene sempre sostituita, nella quarantana, con il corrispondente femminile.
Ventitré... eran di questo numero: Nel XXIX capitolo è stata descritta la nuova condizione, disarmata, dell’innominato convertito, e le modifiche operate nella sua casa e nelle sue abitudini dall'inizio della nuova vita. Ora, spinto dagli eventi esterni, il personaggio ha riorganizzato una difesa militare per il suo castello, e arriva a guidare nuovamente una spedizione, collocandosi, disarmato, alla testa di una squadra di uomini armati da capo a piedi (199-200). All’indugio sulla figura, sempre grandiosa, dell’innominato, segue un quadro corale dedicato alla popolazione ospite del castello. Termini e organizzazione del discorso sono gli stessi già impiegati dall’autore nelle descrizioni di massa dei tumulti milanesi (capitoli XII e XIII): parole ricorrenti sono moltitudine (223); folla (249-50); crocchi (250). All’interno della folla l’occhio del narratore è attento a cogliere il formarsi di correnti e schieramenti, il delinearsi di amicizie, complicità, opposizioni. Ma, a differenza di quanto accadeva durante la sommossa milanese, le popolazioni vittime della guerra sono pacifiche, non esasperate, piuttosto rattristate dalle dolorose esperienze. Dunque il coro dei fuggiaschi è inoffensivo, non ispira al narratore terrore o ripulsa, ma partecipazione e comprensione umana. È indicativa in questo senso la totale mancanza, nella descrizione della folla, delle metafore e similitudini che avevano caratterizzato le pagine milanesi (vedi al capitolo XII, l'approfondimento Le metafore della folla). Si trattava infatti di figure dalle connotazioni negative, che esprimevano l’incontenibilità animalesca e la mancanza di razionalità dei movimenti di massa.
Agnese e Perpetua... anche Agnese: Lo stato psicologico di don Abbondio è descritto dalla voce narrante, mentre nei capitoli XXIII e XXIV era stato il curato stesso, in lunghi monologhi, a scandagliare i propri sentimenti. Restando d’un atteggiamento in mutato l’atteggiamento del personaggio, muta lo strumento linguistico che lo descrive, e dal soliloquio si passa all’analisi condotta dal narratore: non è più don Abbondio che guarda dentro di sé per analizzare le proprie passioni, e non è la sua voce a descriverle, ma guarda dentro di sé per analizzare le proprie passioni, e non è la sua voce a descriverle, ma sono delegati al narratore. Anzi, il narratore stesso sottolinea, in vari punti, il proprio particolarissimo ruolo di osservatore, dall’esterno, di una coscienza altrui. Infatti lo stato d’animo del curato è descritto con forme dubitative e giudizi che rimandano alla prospettiva del narratore: La paura […] credo che la gli fosse passata (267-68); doveva capire quanto poco fosse fondata (270-71). La breve analisi psicologica si inserisce in una più estesa descrizione del comportamento del personaggio: in contrasto con l’attività instancabile dell’innominato e con l’operoso affaccendarsi delle donne sta l’inattività di don Abbondio; e il suo isolamento volontario contrasta con la naturale tendenza dei rifugiati a stabilire rapporti, a condividere problemi e preoccupazioni. Il curato è dunque una figura assolutamente isolata, sia moralmente (la sua paura è una mania individuale, non un problema collettivo) sia fisicamente (evita la compagnia).
A tavola poi... libero: L’elenco dei nomi di guerrieri è preparato da alcune righe dedicate al diffondersi, tra i rifugiati, delle voci sulla guerra, alle curiosità, all’organizzazione delle limitate notizie, che passano al vaglio dei novellisti di professione (298), cioè di coloro che si sono assunti il ruolo di narratori, cantastorie della minuscola comunità. Le attese curiose ma anche ingenue della gente, il clima un po' fiabesco che si è diffuso nel piccolo mondo del castello creano lo sfondo ideale per la lista, che si snoda secondo il ritmo vivace e scandito di una filastrocca o di una canzone popolare. La struttura sintattica è ritmata e ripetitiva (lussano [...] passano [...] passano [...] passano [...] passa [...] passa...) i nomi esotici e sconosciuti dei generali sono macchie di colore, che spiccano sul tessuto uniforme delle frasi.  La particolare qualità sonora di queste righe, tale «da rendere quasi l'impressione dell'eco lontana, del rimbombare di quei loro passi sul ponte di Lecco» (Getto 1964), suggerisce un rapporto con i versi del primo coro della seconda tragedia manzoniana, l’Adelchi, dedicati al passaggio degli invasori: voleron sul ponte che cupo suonò. /A torme di terra passarono in terra, /cantando giulive canzoni di guerra. La sfilata dei guerrieri parte da Wallenstein (311), il generale degli eserciti imperiali (per altre notizie vedi nota a V, 414-455). Segue il belga Giovanni Merode (312), morto nel 1633 combattendo contro gli svedesi. Anhalt e Brandeburgo sono due principati tedeschi; i cavalli di Anhalt (312) sono forse quelli condotti da Luigi di Anhalt Coethen, che combatté nella guerra dei Trent'anni. Passano quindi Ernesto Montecuccoli (313), generale dell'artiglieria imperiale, morto nel 1633; il colonnello di cavalleria Pietro Ferrari (314); l’austriaco Giovanni Aldringer (Altringer, 314), autore del sacco di Mantova nel 1630; continua la sfilata dei guerrieri con Egon VIII von Furstenberg (314), feldmaresciallo imperiale, uno dei protagonisti della guerra dei Trent’anni; Rodolfo Colloredo (315), conte di Waldsee, in seguito governatore di Praga; Torquato Conti (315), duca di Guadagnolo, generale della Chiesa; Matthias Gallas (Galasso, 317), che partecipò come luogotenente del Collalto all’assedio di Mantova, e ottenne dopo aver cospirato contro il Wallenstein il comando degli eserciti imperiali. I Croati (315) sono squadroni di cavalleria al servizio dell'Austria. La fonte di queste informazioni storiche fu, per Manzoni, una lettera latina del medico pavese Sigismondo Boldoni, scritta nel settembre 1629 da Bellano, punto di passaggio obbligato (XXVIII, 800) delle truppe (Bezzola 1961).
Già quelli delle terre... fracasso di questa sorte: L’osservazione del sarto (s'ha da far de’ libri in istampa, sopra un fracasso di questa sorte, 355-56) è coerente con la sua cultura, e con il tipo di libri che gli interessano: quelli che raccontano storie avventurose, meravigliose o miracolose. La sua biblioteca (XXIV, 398-402) comprende infatti leggende sacre e romanzi cavallereschi, e da queste letture il personaggio ricava sempre qualche bella cosa da raccontare (XXV, 205). Dunque i libri, nell'ottica ingenua e appassionata del sarto, contengono avvenimenti straordinari, come è straordinaria la congiuntura storica che i personaggi stanno vivendo. D'altro lato il narratore stesso, nell’Introduzione, spiega di voler riscrivere l’autografo seicentesco perché la storia a me era parsa bella, come dico; molto bella (87-88). Dunque i Promessi sposi raccontano (anche) una bella storia, e le parole del sarto sono una specie di profezia del futuro romanzo. Infatti «Chi gli dà ascolto alla fine è il narratore [...] che si è trasformato nello storico di quegli eventi» (Raimondi-Bottoni 1988).
Dopo un'altra... tali artisti: Si succedono tre scene di desolazione e di rovina: i campi e i paesi, osservati da tutti e tre i personaggi; la casa di Agnese, descritta secondo la sua stessa prospettiva; la casa di don Abbondio, filtrata attraverso il punto di vista suo e quello di Perpetua. Mentre Agnese si impegna fin dall’inizio a rimediare ai danni, senza indugiare nelle malinconie o nei ricordi, la reazione di don Abbondio è più lenta, e la descrizione si concentra più sull'analisi delle rovine che sull'impegno di ricostruzione. L'ultimo quadro è infatti il più particolareggiato, e quello che suggerisce più fitti rapporti con lo stesso ambiente prima della distruzione: il bracciolo di seggiola (400) appartiene al seggiolone di don Abbondio, dove il curato sedeva nei momenti di lettura (VIII, 1-3); lo sportello d'armadio (401) è quello del mobile dove il curato conservava i suoi tesori, aperto con atteggiamento guardingo davanti a Tonio la sera del matrimonio mancato (andò a un armadio [...] aprì una parte di sportello, VIII, 120-23); infine la botticina, dove ci stava il vino che rimetteva lo stomaco a don Abbondio (402-03) ricorda la conclusione del capitolo I, quando il curato, rientrato a casa dopo l'incontro coi bravi, chiede a Perpetua datemi un bicchiere del mio vino (I, 595-596).
Ah porci... disastro passeggiero: «Don Abbondio e Perpetua, nel constatare la rovina della casa, sono concordi nelle parole e nei gesti, fino al momento culminante [...]. A questo punto il gruppo concorde è destinato a dividersi irreparabilmente» (Getto 1964). La scoperta del furto del tesoro innesca infatti la catena dei battibecchi tra serva e padrone, che prosegue quando la donna pretende che il curato richieda le sue proprietà a chi le ha sottratte. Il capitolo si chiude quindi con uno stacco netto, introdotto dalla congiunzione avversativa Ma (465). Il nuovo scenario (sarà quello, terribile, della peste) non viene annunciato esplicitamente dal narratore, che si limita ad anticipare la gravità e l'ampiezza degli eventi che seguiranno, in contrasto con l'angustia delle preoccupazioni private del curato. Il gruppo dei capitoli XXIX e XXX risulta così incuneato tra due sezioni soltanto storiche: la carestia e la guerra descritte nel XXVIII, la pestilenza che dominerà il XXXI e il XXXII. Non solo, ma la storia privata di Agnese, Perpetua, don Abbondio si disegna sullo sfondo della storia grande, e si interseca continuamente con gli eventi bellici. La centralità, in questi due capitoli, del personaggio di don Abbondio, sembra a questo punto spiegarsi col bisogno dell’autore di sottolineare il contrasto tra l'immensità dei problemi storici e l'angustia dei problemi privati. Così il più egoista dei protagonisti, quello che si muove nell'universo mentale più limitato, è scelto per recitare la sua parte sullo sfondo della devastazione dei lanzichenecchi. E le sue apprensioni private (466), a confronto di una tragedia collettiva, risultano ancora più piccole, e più comiche.
concorso: affluenza di persone;
sboccati: sbucati; 
barattavan: scambiavano; 
dargli ombra: infastidirlo; 
voglion far altro: hanno ben altro da fare.
noia: fastidio; 
menar le gambe: scappare; 
si mette all’ordine: prepara; 
non mi ci colgono: non mi prendono, non mi coinvolgono; 
riportare: ripetere; 
picchetto: gruppo di guardia; 
licenziò: congedò.
rimembranza: ricordo; 
creanze: buone maniere.
di rimpetto: di fronte; 
masnada: banda; 
rispondeva: si affacciava; 
andito: corridoio;
provvisioni: provviste.
si desse all’armi: venisse dato l'allarme;
foraggieri: soldati addetti al rifornimento; 
ricevette avviso: fu informato; 
messo a sacco: saccheggiato; 
far alto: fermare; 
costumi: abitudini; 
seguisse: capitasse; 
premura: sollecitudine, attenzione.
capi scarichi: buontemponi, persone spensierate; 
figurarsi: immaginarsi; 
guasto: danni; 
di conserva: insieme; 
discrezione: senso della misura (nell'approfittare dell'ospitalità); 
s’eran rizzate: erano sorte;
quell’asilo: rifugio; 
discostò: allontanò; 
serra serra: scontro armato; 
bazzicava con: ne frequentava; 
gli fosse dato sulla voce: gli fossero fatti bruschi rim-proveri; 
a un bisogno: in certi casi; 
abburattavan: vagliavano, selezionavano;
stazioni: tappe.
squadron volante: «secondo la terminologia militare, squadrone meno numeroso di uno squadrone ordinario e senza una posizione fissa nello schieramento di battaglia» (Raimondi-Bottoni, 1988); 
palchi: serie di rami che si trovano quasi allo stesso livello; 
fronzuti: frondosi; 
sbrancati: sbandati, dispersi;
gruppetto: rotolo;
sporchizie: turpitudini; 
tralci: rami della vite; 
scapezzati: troncati nella parte superiore; 
impannate: tele collocate al posto dei vetri delle finestre; 
zaffate: ondate.
rigovernare: lavare; 
legnaiolo: falegname; 
ruspi: monete; 
tanfo: puzza; 
doga: asse; 
rimetteva: riaggiustava; 
per ristoro: per divertimento.
baroni: bricconi (corrisponde al baron del dialetto milanese); 
diviato: difilato; 
morto: denaro nascosto; 
smorbare: disinfettare; 
semenza: origine;
giornalmente: ogni giorno; 
alla spicciolata: sparpagliati;
congetturato: supposto; 
apprensioni: preoccupazioni.