Qui, tra i poveri... s'ingegni: Lo sguardo del narratore si posa fin dall’inizio del capitolo su don Abbondio. Dal grande affresco storico del capitolo precedente si passa dunque a considerare prima le ragioni di una folla anonima, e infine viene messo a fuoco il singolo individuo. L’occhio del narratore compie in questo modo un movimento dall’alto verso il basso, dall’universale al particolare, planando gradatamente verso l'oggetto della sua attenzione finale (don Abbondio). Cortenuova, Primaluna, Introbbio, Pasturo, Barsio, Balabbio (8-10) sono paesi della Valsassina, tra Bellano e Lecco: «il Manzoni trascrive foneticamente, dal dialetto, alcuni toponimi, la cui grafia ufficiale è oggi un’altra. Oggi infatti scriviamo “Introbio”, “Barzio”, “Ballabio”» (Bezzola 1961). L'elenco dei nomi ricostruisce con maggiore precisione il percorso delle truppe già annunciato alla fine del capitolo XXVIII: si gettarono poi sopra Bellano; di là entrarono e si sparsero nella Valsassina, da dove sboccarono nel territorio di Lecco (800-02). I lanzichenecchi (20), o «lanzi», sono soldati mercenari tedeschi. Il loro nome è l’italianizzazione del tedesco Landsknecht, cioè servitori (Knechte) della patria (Land). I cappelletti (35) sono soldati a cavallo della Repubblica di Venezia, chiamati così per il loro tipico elmo senza visiera, simile a un cappello.
Oh povero me... tal sia di loro: Don Abbondio non recita mai da solo le sue scene madri: ha sempre bisogno di una spalla. Nei capitoli ambientati al paese, il curato faceva la sua apparizione solo, ma ben presto il palcoscenico si popolava di nuove presenze (i bravi nel capitolo I; Renzo nel capitolo II; Perpetua, Tonio e Gervaso nel capitolo VIII). I grandi soliloqui dei capitoli XXIII e XXIV si sono verificati in presenza dell’innominato, causa e ragione delle riflessioni del parroco. Nei capitoli XXV e XXVI don Abbondio era co-protagonista di un lungo dialogo con il cardinale Federigo. E in questo capitolo e nel successivo la funzione di spalla è ricoperta da Agnese e Perpetua. Dunque, il non-eroe del romanzo non conosce la solitudine (a differenza di Renzo, che vive sempre solo i momenti culminanti del suo percorso di formazione). Infatti le caratteristiche di don Abbondio emergono sempre dal confronto, dal rapporto con altri personaggi che sollecitano le sue reazioni. L'innominato e Federigo Borromeo sono per esempio due figure grandiose che fanno risaltare, per contrasto, la pochezza di don Abbondio. Ma persino Agnese e Perpetua, due donne del popolo, sottolineano, con il loro diverso comportamento, l'incapacità del curato di gestire qualunque situazione. Cambia però il registro stilistico: dopo il soliloquio in presenza dell’innominato, i silenzi intervallati da balbettii nel dialogo con Federigo, si assiste, con Perpetua, a vivaci scambi di battute. I colloqui tra serva e curato si svolgono secondo un modulo ripetitivo: dubbiose domande di don Abbondio (Come faremo?, 87; Ma dove andiamo?, 101), sbrigative risposte di Perpetua che, più che spiegare o rassicurare, impartisce ordini (Ma, ma; dia qui; tenga qualche soldo, per quel che può occorrere; e poi lasci fare a me, 91-92).
Presero per i campi... concluse don Abbondio: Dopo essersela presa con don Rodrigo, l’innominato, il cardinale Federigo, Lucia (XXIII, 548-611), protagonisti della sua storia individuale, e con la mula (XXIV, 228-30) che lo trasportava, don Abbondio trasferisce gli identici motivi di stizza sugli eroi della grande storia, accomunati dalla tendenza a complicarsi la vita per ragioni a don Abbondio del tutto incomprensibili. Infatti, l’istinto incontrollabile della mula, il capriccio di don Rodrigo, lo zelo santo di Federigo e dell’innominato, e le ragioni della politica internazionale stanno, per il curato, sullo stesso piano. Alle ragioni di don Abbondio si contrappongono quelle di Perpetua, compendiate nella frase proverbiale "ho dovuto far da Marta e Maddalena" (227-28), che traduce in italiano un'espressione proverbiale del dialetto milanese (fa de Marta e Madalena significa "comandare e agire", "fare due cose insieme"), e riecheggia un noto passo del Vangelo di Luca (10, 38-42), dove si contrappongono Marta, simbolo della vita attiva, e Maria Maddalena, simbolo della vita contemplativa. Agnese, a sua volta, espone le proprie angustie: l'autunno sul quale avevano fatto assegnamento (234-35) è il momento previsto da madre e figlia per rivedersi, dopo la partenza di Lucia con donna Prassede, entro otto o nove mesi (XXVI, 461-62). La calata dei lanzichenecchi ha reso il programma impraticabile. Il duca di Nevers (193) è Carlo I Gonzaga, pretendente alla successione del ducato di Mantova; l’imperatore (196) è Ferdinando II d'Asburgo (per ulteriori notizie sui personaggi coinvolti nella guerra vedi nota a V, 414-455); il governatore (200) di Milano è don Gonzalo Fernandez de Cordova (per cui vedi nota a XII, 73-141).
Furono... quella giornata: In apertura di capitolo dominava il tema della casa abbandonata e prossima alla violazione: da rifugio sicuro, la casa si è trasformata, per don Abbondio, Perpetua e Agnese, in luogo esposto alle insidie della storia non meno degli spazi esterni: "Fino a questo momento, in tutte le situazioni più difficili della sua vita (l’incontro con i bravi, lo scontro con Renzo, il tentativo di matrimonio clandestino, il viaggio al castello dell'Innominato), don Abbondio aveva sempre cercato un rifugio fra le pareti sicure della sua casa, dietro un uscio ben sprangato. La casa è stata fin qui per lui un istintivo punto di riferimento, un naturale luogo di protezione. Solo nel forzato colloquio con il cardinale, il nemico, per così dire, era entrato in casa, senza che fosse possibile allontanarlo. Ma si trattava pur sempre di un nemico disarmato" (Getto 1964). Dopo la trasformazione della casa dei tre fuggiaschi da rifugio a luogo di pericolo, entra in scena una nuova casa, quella del sarto, che, come già per Lucia (vedi la nota a XXIV, 317-387), si rivela uno spazio totalmente positivo. Non solo infatti la casa del sarto è al di fuori del percorso delle truppe, quindi sicura; ma è anche accogliente, e vi si realizza, minutamente descritto, il rito del cibo, che ha sempre contrassegnato, nel corso del romanzo, gli ambienti popolari e rassicuranti (vedi nota a XVI, 181-242).
Cosa ne dice... del viaggio: La presenza di don Abbondio consente al sarto una nuova esibizione. Dapprima stabilisce un rapporto tra gli eventi storici e i fatti straordinari narrati nei suoi libri: la storia de’ mori in Francia (305) è oggetto dei prediletti romanzi cavallereschi; la Tebaide (330) è la regione della Grecia dove si rifugiavano gli anacoreti, monaci dediti alla preghiera e alla solitudine, le cui vite erano narrate nel Leggendano de’ Santi, l’altra lettura favorita del sarto (vedi XXIV, 400). Il secondo tempo del piccolo show non ha più come oggetto le parole, ma le immagini, anzi il ritratto di Federigo Borromeo. Se nei Promessi sposi i personaggi popolari tendono a diffidare delle parole, specialmente quelle scritte, e ad affidarsi alla verità dei segnali naturali, percepibili con gli occhi (vedi la nota a I, 103-125), il sarto, nel suo ingenuo entusiasmo per la cultura, rappresenta l’unica deroga a questa legge. Infatti, mentre si serve delle sue letture come chiave di interpretazione della realtà, rileva la scarsa attendibilità dell'immagine: insomma, i libri dicono il vero, il ritratto del cardinale mente. Le parole del sarto e di Agnese possono anche essere lette come una dichiarazione di sfiducia, da parte dell'autore stesso, nelle arti figurative, materia che fu in effetti piuttosto estranea a Manzoni, scrittore assai poco influenzato, nella sua opera, dalle espressioni artistiche antiche o contemporanee. Dunque gli umili manzoniani attribuiscono maggiore attendibilità alle immagini che alla parola; al contrario l’autore, che si misura costantemente con la parola nel suo mestiere di scrittore, nutre una certa diffidenza per le immagini. In quest'ottica il breve scambio di battute tra Agnese e il sarto non rappresenta una contraddizione rispetto alla concreta fiducia dei protagonisti nelle immagini, ma testimonia piuttosto l'indifferenza del Manzoni stesso verso i problemi storico-artistici: «Che Manzoni nutrisse, lui così esperto nell’uso dello strumento linguistico, una fondamentale diffidenza per il fatto figurativo mi pare fuori di dubbio. Quando non bastasse la testimonianza della sua opera, o dei brevi rapporti con gli artisti contemporanei, lo scrittore appare venire allo scoperto per bocca dei suoi umili protagonisti, cioè Agnese e il sarto, nel dopocena del capitolo XXIX» (Mazzocca, OFFICINA PS).
Il sarto aveva... o meno: La nuova vita dell’innominato è descritta dalla voce narrante, che alterna i tempi verbali del trapassato prossimo (aveva mostrato, 370), riferito alle abitudini ormai superate, e dell’imperfetto (mostrava, 371; andava, 372...), che ha «valore durativo, in rapporto a ciò che è divenuto un costume, un ‘sistema’ di vita» (Raimondi-Bottoni 1988). Non solo i tempi verbali, ma l’intera struttura delle frasi è organizzata sul rapporto tra passato e presente. Talvolta l'opposizione tra il prima e il dopo si esprime grazie alla ripetizione di un concetto, con variazione del tempo verbale e degli avverbi di tempo (Quel coraggio che altre volte aveva mostrato [...] ora lo mostrava, 369-71). Un’altra costruzione significativa è quella che istituisce un rapporto di comparazione tra passato e presente (era rimasto non meno inviolato di quando..., 379-80). Si noti anche la collocazione simmetrica di nomi e aggettivi di significato opposto (La rimembranza dell'antica ferocia, e la vista della mansuetudine presente, 381-82). Insomma, la nuova grandezza dell'innominato è riconoscibile in rapporto all'antica, ugualmente potente anche se di segno opposto.
Queste medesime... inermi e rispettati: L'innominato viene sempre chiamato dalla voce narrante, in queste pagine, uomo, e il termine si ripete con frequenza significativa (386; 393; 406; 407; 415; 454). Al momento della sua prima apparizione nel romanzo, il personaggio, evocato nei pensieri di don Rodrigo, era stato definito un uomo o un diavolo (XVIII, 138-39). L'insistenza sul primo dei due epiteti per definire l’individuo convertito ribadisce dunque che una scelta è stata compiuta, e che questa scelta ha privilegiato la via positiva, rinunciando a tutte le prerogative diaboliche che appartenevano alla vita criminale. Accanto all’appellativo uomo compare, una sola volta nel capitolo, quello di santo (436), che risulta però appartenere non alla voce del narratore, ma all'opinione pubblica. Infatti, le voci popolari definiscono ormai l’innominato santo (vedi nota a XXIII, 531-611), e il romanzo si limita qui a registrarne l'eco. Dunque, come il narratore non ha mai chiamato «miracolo» la conversione dell’innominato, limitandosi a registrare l’interpretazione popolare in tal senso (vedi nota a XXIV, 92-200), così egli permette che l’innominato sia chiamato santo dalla voce degli altri personaggi, ma, parlando in prima persona, si limita ad attribuirgli il titolo di uomo, che assume qui il valore pregnante di individuo che, grazie alla conversione, ha pienamente realizzato le proprie potenzialità e la propria missione nel mondo. La vera santità, per il cattolico Manzoni, non è oggetto su cui possano deliberare gli uomini, e dunque non spetta alla voce del narratore, che è sempre garanzia, nei Promessi sposi, di verità assoluta, confermare un’interpretazione della vicenda non avallata dall'autorità della Chiesa. Il luogo, altrove citato, del Ripamonti (472-73) è il quinto libro della quinta decade della sua Storia Patria (XIX, 376-77), che il narratore aveva appunto indicata come fonte delle sue informazioni sull’innominato (Da questo scrittore prenderemo qualche altro passo, che ci venga in taglio per confermare e per dilucidare il racconto del nostro anonimo, XIX, 386-89).
Ma quando, al calar... sua strada: Al culmine di una descrizione dell’innominato che definiva le caratteristiche dell'uomo nuovo in rapporto a quelle dell’antico, ecco il signore trasformarsi di nuovo in generale, ma restando disarmato alla testa di un esercito di armati. La figura dell’antitesi, che aveva accompagnato il personaggio fin dal primo momento della sua apparizione (vedi nota a XIX, 435-508), assume qui la massima evidenza. Infatti, la situazione e il comportamento dell'innominato (che tiene ai suoi uomini un discorso, come è consuetudine di ogni generale prima della battaglia) sono tipici di un contesto di guerra; ma con ciò contrasta il rifiuto del signore di portare armi su di sé. Giovanni Torti (1774-1852), poeta milanese allievo di Parini, fu amico di Manzoni e fece parte della cerchia di intellettuali romantici che ruotava attorno all'autore dei Promessi sposi. Tra i suoi pochi (507-09) versi, si ricorda il carme Sui «Sepolcri» di Ugo Foscolo e di Ippolito Pindemonte (1808). Il ricordo dell'amico poeta è analogo a quello dedicato a Tommaso Grossi nel capitolo XI (vedi nota a 361-431).
portamenti: comportamenti; 
impiccio: imbarazzo, indecisione;
ariani: eretici, infedeli; 
consultare: chiedere informazioni c opinioni; 
risoluto: deciso; 
in una tirata: in una sola tappa forzata; 
tenere in suggezione: tenere a freno; 
stralunato: stravolto; 
concertare: concordare; 
bugigattoli: ripostigli; 
partiti: possibilità.
congiuntura: situazione: 
si sbrigava: si liberava; 
tumultuaria: confusa, frettolosa;
luterani: di religione protestante;
l'hanno per: la cosidettirano;
tiravan di lungo: tiravano dritto, proseguivano; 
munizione da bocca: cibo; 
gerla: cesta che si porta dietro le spalle;
le avevan fatto tanto pro: le erano tanto serviti; 
spicciolare: cambiare;
rimpiattando: nascondendo; 
a dispetto: contro la volontà; 
cimento: prova;
per aria: in alto, su una cima;
a mal partito: nei guai; 
cigne: cinghie;
bordone: bastone da viaggio, col manico ricurvo;
toppa: serratura;
guardarle: custodirle;
interiezione: esclamazione;
lasciar correr l'acqua all'ingiù: lasciare che le cose seguissero il loro corso, non pretendere l'impossibile;
non istar su tutti i puntigli: non impuntarsi anche su aspetti di trascurabile importanza, 
anderà a male: finirà male;
seguirà: capiterà: 
ospitazione: alloggio militare (dal latino medievale hospitatio, che indicava «il diritto di imporre l'alloggio di qualcuno in casa d'altri", Raimondi-Bottoni 1988); 
di buon viso: offerto con cordialità (corrisponde all'espressione milanese de bonna cera); 
d'accozzar... il pentolino: mettere insieme le provviste: 
diricciar: togliere dal riccio: 
primaticce: della qualità che matura per prima;
spillare: far uscire il vino dalla botte; 
provvisioni: provviste; 
ricovero: rifugio; 
alla distesa: senza fermarsi; 
sfrattati: cacciati; 
in furia: di fretta.
quel che è di precetto: il breviario, lettura obbligata per i sacerdoti; 
si ricusano: si respingono (per gentilezza); 
principiano: cominciano; 
altre volte: in altri tempi, 
rimembranza: ricordo;
promettersi: sperare; 
impicciato: in difficoltà: 
compunzione: pentimento; 
di ritegno: a trattenerli.
cagioni: cause;
avvezzo: abituato;
stare a dovere: comportarsi correttamente; 
facinoroso: criminale;
stornare: dissuadere;
alle prese: in disaccordo; 
proteste: affermazioni; 
di conserva: di comune accordo;
l'oblivione: cellazione delle colpe.
di più alto affare: di categoria sociale superiore; 
accomodarsi: adattarsi; 
terzo: reggimento (dallo spagnolo tercio); 
a minuto: con piccole azioni di violenza individuale; 
inermi: disarmati; 
far delle loro: comportarsi come era loro proprio, cioè devastare e saccheggiare; 
parlata: discorso; 
contenersi: comportarsi; 
a tetto: sotto il tetto; 
in asta: armi composte da un'asta di legno sulla cui cima è innestata una lama.
all'entrature: ingressi. 
dar la muta: effettuare il cambio delle sentinelle;
s'era costumato: sì era fatto abitualmente;
sacconi: pagliericci, 
strapunti: materassi, 
provvisioni: provviste.