Quel ramo del lago di Como: L'attacco del romanzo descrive i luoghi in cui si svolgono le azioni principali: è un inizio lento e circostanziato, di gusto analitico e quasi topografico, con una dovizia di particolari che a taluno è apparsa eccessiva («Tra tutti quei seni e golfi, e poggi e valloncelli, e erte e spianate, noi ci sperdiamo un po’»: Russo); una pagina che non vuol essere lirica e abbandonata alla nostalgia dei ricordi (Manzoni soggiornò a lungo nella prima giovinezza presso Pescarenico) ma essenzialmente oggettiva, quasi per fissare uno scenario stabile che non verrà mai meno, sia pure idealmente, nel corso del racconto: un punto di convergenza e di orientamento spaziale e, soprattutto, spirituale. L’andante ritmico della prosa, impostato dal novenario d'apertura, con la disposizione degli elementi a gruppi calibrati e talora a coppie («a seni e golfi», «dello sporgere e del rientrare»...), sottolinea a poco a poco l’animarsi del paesaggio, il suo cambiar forme e aspetti fra lago, fiume, torrenti e monti; silente e maestoso, ma segnato dell’uomo e dalla sua fatica.
costiera: pendio tra il monte e la riva.
tre grossi torrenti: il Gerenzone, il Galdone il Bione.
costa: pendice dei monti.
terre... ville... casali: paesi, villaggi, case sparse.
castello: roccaforte con guarnigione di soldati.
Ai tempi in cui accaddero... le fatiche della vendemia: L'intervento del narratore («Ai tempi in cui accaddero i fatti che prendiamo a raccontare) interrompe la descrizione con un breve vuole commento storico amaramente ironico, che vuole far intendere, per antifrasi, esattamente l'opposto di ciò che dice: che bell'onore e quale vantaggio avere una guarnigione spagnola! E quali lezioni di modestia, di rispetto e di laboriosità erano impartite dai soldati agli abitanti del luogo! Si delinea già uno scorcio del Seicento e sue ingiustizie, le prepotenze, i soprusi (non solo degli stranieri); ma, al di là di quel secolo, vi è per l’austero sentimento etico-religioso del Manzoni un dato di fondo che percorre la storia tutta: la violenza degli oppressori sugli oppressi, la forza iniqua che si ammanta delle ragioni speciose del diritto, l'abuso del potere che stravolge la giustizia a strumento di persecuzione dei deboli. Una violenza che, fra i suoi molti effetti negativi, intacca anche le fondamenta morali della famiglia, insultando la dignità della donna e del lavoro, ed è per questo tanto più deprecata dall'autore.
tuttavia: tuttora.
prospetti: prospettive, panorami.
Il luogo stesso... magnifico dell'altre vedute: La descrizione, dopo la parentesi storica, riprende con un tono più vibrante e poetico, chiamando il destinatario a partecipare direttamente al maestoso spettacolo della natura.
bel bello: pacifico e tranquillo.
curato d'una delle terre accennate di sopra: Sant'Abbondio è il patrono di Como: il Manzoni ha dunque dato al suo personaggio un nome locale. Per ora è solo un nome senza ritratto, rimandato al cap. VIII. Non ha importanza sapere quale sia il paese di cui è curato (Acquate, Olate o Maggianico): il Manzoni ha opportunamente sfumato, qui e altrove, l’ossequio del vero. 
fessi: fenditure.
voltata: svolta.
Aperto poi di nuovo... anche quel giorno: La passeggiata fotografa il personaggio, ne svela l'animo attraverso i gesti meccanici e abitudinari: un prete tranquillo, che si gode i piaceri modesti del luogo, senza alcuno slancio sentimentale («alzava il viso, e, girati oziosamente gli occhi all’intorno...»), badando anzi a evitare intoppi fastidiosi. Non ci pare che tutto cio mostri un «temperamento idillico», come pensa il Russo.
cura: casa del curato, canonica.
I muri interni... con qualche scalcinatura qua e là: Non v'è certo dileggio della pietà popolare, che si finge le anime purganti tra il fuoco purificatore, bensì una nota umoristica a proposito delle forme serpeggianti e puntute di quelle figure, com'erano riuscite all’arte rozza del pittore. Una macchia, ancora, di colore locale e storico, con un pizzico di humour: quelle anime in pena, inoltre, sembrano prefigurare il prossimo tormento di don Abbondio.
congegnate come in cifra: a formare disegni decorativi.
a conoscere per individui della specie de' bravi: I bravi sono una sorta di sgherri, di sicari assoldati da signori prepotenti come guardie del corpo e manovalanza del crimine. Questi due, che attendono don Abbondio, hanno dipinta addosso l'arroganza intimidatoria di delinquenti incalliti: soprattutto la vistosa esibizione degli abiti e delle armi, che non rinuncia a una nota di pacchiana eleganza (la reticella con la nappa, il ciuffo, i mustacchi arricciati, la cintura «lucida», lo spadone a lamine «forbite e lucenti»), dà misura di una «vanitosa ribalderia» (Russo), i una ostinata esaltazione della violenza. 
Fino dall'otto aprile dell'anno 1583: L'ampio excursus delle gride non è piaciuto a taluni critici perché interromperebbe inutilmente la narrazione. Il Manzoni, tuttavia, non vuole concedere nulla al pittoresco o al romanzesco, sicché storicizza i ritratto dei bravi con ampie citazioni di bandi del tempo (le gride), alle quali alterna i suoi sarcastici riassunti e commenti. Come nell’Introduzione, il narratore lascia spazio alla voce del Seicento, non più all’anonimo ma ai proclami burocratici di quei «Prencipi e Potentati», pomposi quanto inerti reggitori politici, che, nel rovesciamento dell'ironia, assommano tutti i tratti Negativi della falsa giustizia: la millanteria impotente che si sfoga in vuote minacce e con l'acquiescenza aggrava le sofferenze degli oppressi.
Contestabile: è un'alta carica militare.
Sua Maestà Cattolica: Filippo II, re di Spagna.
esercizio: lavoro.
stranamente: straordinariamente.
grida: bando, proclama (detto così perché veniva “gridato” dai banditori).
alla corda et al tormento: endiadi: alla tortura della corda (alla quale il «reo» veniva appeso per le braccia).
per processo informativo: come mezzo d’indagine. Si sente la ripugnanza del nipote di Cesare Beccaria per siffatte aberrazioni giuridiche.
galea: nave su cui i condannati erano costretti a remare; la parola designa, in genere lavori forzati (ne derivano i termini “galera e “galeotto”).
tanto: così grande (latinismo).
sbrattare: ripulire (cioè sgomberare).
appostatamente: con agguati.
si rendono più facili: si abbandonano più facilmente.
confidati: confidando.
onninamente: del tutto (latinismo).
comminazioni: minacce.
cabale: intrighi.
Enrico IV: re di Francia.
il duca di Savoia: Carlo Emanuele I.
il duca di Biron: maresciallo di Enrico IV; venne spinto dal conte di Fuentes a complottare contro il re e fu perciò decapitato (si noti il doppio senso di «fece perder la testa»).
quel seme tanto pernizioso de’ bravi: la frase fa il verso, ironicamente, alla grida.
stampatori regii camerali: stampatori della Regia Camera, dell’amministrazione statale.
a un tratto: assieme.
galantuomini: è detto con ironia. Quanti «galantuomini» incontreremo nel romanzo!
Affrettò il passo... e si fermò su due piedi: Spiace a don Abbondio che i malfattori aspettino proprio lui: lo scambio di occhiate e di cenni d'intesa, subito afferrato con terrore, il loro avvicinarsi deciso non lasciano dubbi. La mimica del volto e la sequela dei gesti segnano il crescere della tensione interiore, a stento dissimulata dalla finta lettura, dal comico rassettarsi il collare per adocchiare qualche insperato soccorso, dallo stesso sorriso meccanico che il curato si dipinge (o, per meglio dire, si maschera) in faccia, prima di piantarsi come un automa davanti ai due loschi figuri. La psicologia è quella di un rassegnato che, non potendo fuggire, affretta un esito fatale. L'esame di coscienza è alquanto rassicurante (non del tutto), non avendo egli peccato contro alcun potente; eppure lo sguardo fisso e risoluto dei bravi è come un'accusa. Il breviario, inutile libro religioso, serve solo al contegno esteriore, non all’animo che è vuoto di carità. Lo humour dello scrittore non indica condiscendenza ma distacco morale.
Renzo Tramaglino e Lucia Mondella: i protagonisti del romanzo. «Il nome Lorenzo è nelle Litanie dei Santi in una serie che non possiamo non dire manzoniana: "Bartholomaee...Laurenti...Gervasi. Ambrosi...Antoni, Dominice".Vi figurano infatti, oltre a Lorenzo (detto da tutti Renzo), anche Bortolo, Tonio e Gervaso, il sagrestano Ambrogio, il piccolo Menico. In quanto a "Tramaglino”, è evidente l’allusione alla professione di filatore (“tramaglio”: rete, cfr. cap. IV, nota 2) che era appunto il mestiere di Renzo [...]. Nel Canone della Messa si legge: “Nobis quoque peccatoribus...cum Felicitate, Perpetua, Agatha, Lucia, Agnete, Caecilia, Anastasia”. La serie Perpetua-Lucia-Agnese-Cecilia e soprattutto il binomio Lucia-Agnese lasciano intendere donde il Manzoni abbia derivato il nome della giovane sposa. In quanto a "Mondella”, può esserci riferimento alla purezza della fanciulla» (Caretti).
comune: comunità.
Disposto... disposto sempre all’ubbidienza: «Disposto... disposto sempre all’ubbidienza» dirà alla fine don Abbondio; ma già la formula di cortesia, con cui si presenta ai «galantuomini» dallo sguardo inquisitorio, oltreché intimidatorio, rivela acquiescenza e sottomissione. La strategia del disimpegno, il penoso tentativo di giustificarsi con quegli «uomini di mondo», svilendo le nozze di Renzo e Lucia a volgari «pasticci», attestano un animo gretto e vile. Dice bene il De Sanctis: «Che cosa è questo cioè? E l’uomo che si mette subito nella posizione di chi ha il torto, perché è avvezzo a tremare dinanzi al più forte». Del resto, don Abbondio è subito un «inferiore» colto in fallo persino nelle intenzioni; ed è psicologicamente già pronto a subire il sopruso: cerca solo di trarsi d’impiccio in qualche modo («se mi sapessero suggerire...»). I due bravi, con mezzi diversi di persuasione — non privo di una sua abilità diplomatica il primo, l’«oratore», più sbrigativo e violento il taciturno «compagnone» — non durano fatica a piegare le ultime resistenze, gettando ne discorso il nome di don Rodrigo, al quale don Abbondio non può che inchinarsi. E finiscono addirittura con l’irridere la vittima («suggerire a lei che sa di latino»), sbeffeggiandone l'impotente cultura.
messere: nel Seicento la parola si usava come titolo proprio del parroco.
trascrivere: dal manoscritto dell’anonimo.
aggranchiate: rattrappite.
naturale: carattere.
Come stesse di dentro... del suo naturale: L’ultima immagine del «povero don Abbondio», ancora sbalordito per tura e arrancante verso casa con le gambe aggranchiate dalla paura, nasconde dietro l'umorismo una sottile nota di rincrescimento, se non di compassione, che introduce il lettore ad una più profonda comprensione morale del personaggio, grazie al nuovo excursus storico-biografico. Il celebre attacco, («Don Abbondio [...] non era nato con un cuor di leone») non ha, dunque, un pretto valore ironico, se è vero che l'immagine è subito rincalzata da una cruda metafora animalesca («la peggior condizione, a que’ tempi, era quella d’un animale senza artigli e senza zanne, e che pure non si sentisse inclinazione d'esser divorato»), quale esatto emblema dello spirito secentesco. La pagina si allarga dal personaggio alla società e al costume, dominati dalla logica abnorme della forza e dall’inefficacia della legge che lascia «l’uomo tranquillo, inoffensivo» in balia dei prepotenti. L'autore traccia un tremendo disegno di una società in cui la giustizia è forte con i deboli e debole con i forti; dove gli interessi dello stato sono in subordine a quelli dei singoli potenti e violenti o delle piccole oligarchie dei gruppi privilegiati; dove «l'impunità era organizzata, e aveva radici che le gride non toccavano, o non potevano smuovere». L'impotenza della giustizia ufficiale si traduce, paradossalmente, in vessazione dei «pacifici» e dei «deboli» già angariati dai «perturbatori», in una continua minaccia € molestia dell’«uomo bonario» privo di protezione, in un vero e proprio arbitrio senza freno. L'individuo isolato è esposto alle angherie dei più forti che una rete di omertà e di connivenze, di immunità e di privilegi sottrae a ogni punizione. In tal modo l’autore cerca di comprendere, se non di giustificare, la paura di don Abbondio. 
asili: le chiese, i conventi e taluni palazzi nobiliari garantivano, grazie al diritto di asilo, l’impunità ai delinquenti che vi si rifugiavano.
impugnati: contestati.
livrea: divisa.
pezzo di carta: a tanto si riduceva una grida.
tenuto a vile: disprezzato.
il loro titolo: sbirro o birro.
connivenza: sottintesa complicità.
corporazione: persino i medici, tradizionalmente individualisti, avevano formato una corporazione. Leghe, consorterie e corporazioni tendevano a estendere immunità (dispense) privilegi (eccezioni alle norme), esenzioni da imposte o da altri doveri. 
oligarchie: qui nel senso di clan, cricche, gruppi privilegiati.
dovizioso: ricco.
discrezione: giudizio.
Il nostro don Abbondio... di molti vasi di ferro: Quel «nostro» che accompagna il nome dice l'affetto e la comprensione con cui il narratore segue le vicissitudini del personaggio, al quale per altro non risparmia la sua acuminata ironia («vaso di terra cotta, costretto a viaggiare in compagnia di molti vasi di ferro»). Se la metafora animalesca accentuava la brutalità della violenza, questa dei vasi sembra alludere alle conseguenze pericolose del “viaggio” della vita, a quei tempi: all’eventualità assai comune di un urto, di una irreparabile rottura. Don Abbondio e uno di quegli uomini «tranquilli», «deboli», «bonari», «senza difesa», esposti specie in e alle arroganti soperchierie di un don Rodrigo qualsiasi. L'autore ha, dunque, perfettamente inserito l’uomo nel suo tempo, mostrando di comprendere alcune motivazioni generali del suo comportamento. Ora il ritratto si fa morale e psicologico, e perciò più intransigente. C'è una manchevolezza nella scelta del sacerdozio: «non aveva gran fatto pensato agli obblighi e ai nobili fini del ministero al quale si dedicava»; altre sono le ragioni, materiali ed egoistiche. Il giudizio del narratore-autore è inequivocabile e non ammette nessuna giustificazione o remissione bonaria delle colpe. E tanto più l’ironia connota il distacco etico del Manzoni, quanto più il personaggio è scavato in profondità nella sua ideologia gretta e rinunciataria, quel «sistema di quieto vivere» che lo mette al riparo da ogni preoccupazione a scapito del dovere sacerdotale e dell’amore cristiano. Ma qui Dio non è in causa, rimosso nelle pratiche burocratiche del funzionario del sacro. Manzoni, sensibile ai fermenti giansenistici che accompagnarono la sua conversione (e non l'abbandonarono mai), ha un troppo alto concetto dei «nobili fini» del sacerdozio per limitarsi a prendere a gabbo, semplicemente, il «povero» don Abbondio. Se ne condanna il lassismo opportunistico, ne comprende, da vero artista, il carattere agro, intimamente insoddisfatto e un po’ lunatico («fantastico») per i troppi «bocconi amari inghiottiti in silenzio». Il «fiele in corpo» corrobora la sua stizza impotente di uomo mediocre, che non conosce il fiero sdegno del profeta, del magnanimo: in controluce, e per opposizione, si delinea la figura di un autentico testimone del Cristo, padre Cristoforo, forse uno di quei «confratelli» aspramente ripresi dal curato perché «a loro rischio, prendevan le parti d’un debole oppresso, contro un soverchiatore potente». E l’ideologia della viltà arriva persino a giustificarsi nel nome della purezza e della «dignità del sacro ministero»! Sicché l'autore può concludere il ritratto di don Abbondio infingendone la misera filosofia e la sua massima sentenza: «che a un galantuomo, il qual badi a sè, e stia ne’ suoi panni, non accadon mai brutti incontri»; ironizzando colui che «in un piccolissimo crocchio» pontifica e si porta a modello, lontano le mille miglia dal supporre che il sistema possa ammettere un'eccezione: l’incontro di un galantuomo par suo con i bravi.
dissimulando: fingendo di non vedere.
fantastico: lunatico, un po’ strambo.
venticinque lettori: con questa frase, ironicamente bonaria, il narratore chiude la digressione e riprende il filo del racconto.
Se Renzo si potessi mandare... portar la loro imbasciata: Il monologo di don Abbondio è un ronzio di pensieri in tumulto, spesso smozzicati e incompleti e - è da credere — accompagnati da gesti di stizza («E,e,e [...] ih! [...] Oh povero me»). Vengono a galla i residui inespressi di un egoismo congenito e grottesco («Ragazzacci [...] non si fanno carico de’ travagli in che mettono un povero galantuomo. [...] Che c'entro io? Son e voglio maritarmi?»). La colpa è scaricata su Renzo, innamorato di «quella Lucia» fonte prima dei suoi guai: il comandamento dell’amore nel matrimonio è una ragazzata irresponsabile e fastidiosa.
Ma, in quel momento... fretta con un oibò: Don Abbondio non è un malvagio e non può non pentirsi del cattivo pensiero «di non essere stato consigliere e cooperatore dell'iniquità», col suggerire ai bravi di portare a Renzo stesso l'«imbasciata». Sicché rivolge la sua stizza contro don Rodrigo, il «rispettabile cavaliere» sinora riverito e scappellato ad onta di ogni Sopruso.
l'età sinodale: età prescritta dai sinodi perché una donna possa essere al servizio di un prete. 
Era Perpetua... come dicevan le sue amiche: Perpetua non è l’ennesima variante di una tipica figura della commedia, la serva padrona: è, per molti aspetti, il necessario pendant di don Abbondio, un suo «complemento inseparabile» (De Michelis); e il prete ha bisogno di lei per sfogarsi, soprattutto in questa tremenda circostanza. Un motivo convenzionale che può essere quello della zitella a cui brucia di non essersi sposata (e sulle maldicenze delle «amiche» farà leva Agnese nel colloquio notturno del cap. VIII); ma il personaggio trascende il tipo per la vivacità delle movenze e del linguaggio, per la verve comaresca e il sano realismo che ne caratterizzano l'indole genuinamente popolare.
Il fatto sta che don Abbondio... il miserabile caso: Non è difficile, per l’affettuosa curiosità di Perpetua, vincere la piccola battaglia con don Abbondio, che dal suo canto è incapace di custodire il segreto («o è niente, o è cosa che non posso dire») e, anzi, desidera condividerlo con qualcuno: e con chi, se non con l’affezionata, per quanto linguacciuta governante? Un po' con le buone, un po' con le cattive, il segreto salta fuori, anzi il «miserabile caso»: «forma epica — commenta il De Sanctis — come se avesse narrato l’eccidio di Troia».
il nostro arcivescovo: il cardinale Federigo Borromeo.
calar le...: calare le brache (espressione efficacemente plebea).
baggianate: stupidaggini (da baggiano = sempliciotto). Anche don Abbondio usa qui un'espressione popolare e dialettale.
Basta... mangi un boccone: Nel dialogo (si osservi la diversità dei pronomi personali, il «lei» usato da Perpetua e il «voi» di don Abbondio, a sottolineare le differenze sociali e di ruolo fra la serva e il padrone) si fanno luce i diversi caratteri dei personaggi: il prete tremebondo e angosciato, al quale anche il racconto del «miserabile caso» rinnova paura e stizza; la donna, simpaticamente spontanea nelle sue uscite fiere e popolaresche («Oh che birbone! [...] le schioppettate non si danno via come confetti [...] chi sa mostrare i denti [...] pronto a calar le...»). «Perpetua viene come contrapposto poetico di don Abbondio; contrapposto brutale e plebeo, come donna senza educazione [...] grossolana e di prima impressione, che dice tutto senza rispetto alcuni: vivace contrasto con don Abbondio, il quale è tutto prudenza, tutto riguardi, tutto cautele» ( De Sanctis). Quanto al famoso «parere», si vedrà nel cap. XXVI come esso si affacci con meraviglia nella mente di don Abbondio, al quale andranno i rimproveri del cardinale Federigo per non essere stato informato del sopruso. Ma troppo forti sono le ragioni della paura («Quando mi fosse toccata una schioppettata nella schiena, Dio liberi! l'arcivescovo me la leverebbe?»).
Giunto su la soglia... e disparve: Don Abbondio si è forse già pentito di aver rivelato il suo segreto a Perpetua? Il gesto e il tono lento e solenne con cui scongiura la donna, prima di uscire teatralmente di scena, sottolineano, assieme ai brontolii e alle lamentazioni tipiche del personaggio, il rinnovarsi dell'angoscia che lo sfogo ha soltanto sopita.