L'Historia: Come dice il sottotitolo, I promessi sposi: sono «una storia milanese del secolo XVII scoperta e rifatta da Alessandro Manzoni». Questa introduzione, scritta in sorprendente stile barocco, non sarebbe altro — secondo la finzione del Manzoni — che il proemio ampolloso della vicenda narrata in un vecchio manoscritto da un anonimo del Seicento. Colpisce subito il linguaggio altisonante della pagina, infarcita di immagini e metafore bizzarre, intrecciate da una sintassi faticosa e contorta, sicché il senso sembra emergerne a stento. La storia — dice l'anonimo — può essere definita una guerra contro il tempo distruttore per richiamare in Vita il passato; ma gli storici, illustri campioni di tale guerra, preferiscono narrare le grandi imprese di uomini famosi: argomenti e personaggi vietati al mio modesto ingegno, per cui mi limiterò a raccontare fatti capitati a povera gente. In Questa vicenda si assisterà alla lotta fra bene e male, fra imprese virtuose e azioni diaboliche. E considerato che tante malvagità ebbero luogo sotto la protezione del Re di Spagna, del governatore di Milano, dei senatori e dei magistrati, si deve pensare a una qualche fattura del diavolo superiore a ogni malizia umana, contro la quale sono impotenti anche i mille occhi e le mille braccia dei governanti, che tanto si adoperano per il bene pubblico. Ho taciuto i nomi dei personaggi, ma chi non è digiuno di filosofia sa che i nomi sono solo dei puri accidenti...
Ma gl'illustri Campioni... Allori: perifrasi per indicare gli storici che in tale lotta (Arringo) mietono successi gloriosi (Palme e Allori: simboli tradizionali della gloria).
rapiscono... brillanti: rapiscono solo le spoglie (si noti il pleonasmo: solo che le sole) più sfarzose.
imbalsamando... gloriose: gli storici, poco prima definiti campioni in guerra contro il tempo, ora sono imbalsamatori di imprese (co’ loro inchiostri: metonimia: “con i loro scritti”) di Principi e Potentati; e anche ricamatori di Attioni gloriose con l’acutezza del loro ingegno (coll’ago finissimo): tre diverse metafore, del tutto difformi tra loro, che bene esprimono l’alambiccato gusto barocco.
Labirinti de' Politici maneggj: altra metafora per indicare gli oscuri intrighi politici.
Oricalchi: trombe di guerra.
capitorno: capitarono.
gente meccaniche, e di piccol affare: gente che lavora, di poco conto (è la prima definizione dei due “umili” protagonisti del romanzo, Renzo e Lucia, filatori di seta).
schietta e genuinamente: schiettamente e genuinamente (spagnolismo).
Però alla mia debolezza... sia Relatione: L’anonimo, dunque, decide di lasciar memoria ai posteri delle vicende di semplici lavoratori, «gente meccaniche, e di piccol affare»: definizione non certo spregiativa ma che rivela la mentalità dell’intellettuale del Seicento, per il quale la storia non può che essere «illustre»: retorica e ideologica esaltazione delle imprese di personaggi grandi e famosi. Raccontare i casi di Renzo e Lucia significa per l'anonimo rinunciare (con esibita modestia) alle «sublimità pericolose» fra cui si aggirano i veri storici e accontentarsi di fatti sì «memorabili» ma di secondo piano, proprio perché capitati a persone di umile condizione sociale. Con questa scelta, tuttavia, l'anonimo batte la strada che, secondo il Manzoni, conduce al cuore della storia: non quella dei «Prencipi e Potentati, e qualificati Personaggi», bensì quella degli umili, della gente senza storia. Nel Discorso sopra alcuni punti della storia longobardica in Italia il Manzoni scrive: «I cronisti del Medioevo raccontano per lo più i soli avvenimenti principali e straordinari, e fanno la storia del solo popolo conquistatore, e qualche volta dei soli re e dei personaggi primari di quel popolo». Eppure, «un'immensa moltitudine d’uomini, una serie di generazioni, che passa sulla terra, inosservata, senza lasciarci traccia, è un triste ma importante fenomeno». V'è già qui, implicitamente, la scelta di une storia diversa e la polemica con la “storia illustre” che attraversa tutto il romanzo.  
angusto Teatro: allude alla Lombardia, "teatro” delle vicende narrate.
climi: paesi. 
l'amparo: protezione (spagnolismo).
Re Cattolico: Filippo IV, re di Spagna (nota l’iperbole del Sole che mai tramonta). 
l'Heroe... parti: il governatore di Milano che temporaneamente rappresenta il Re: è detto eroe di nobile stirpe e paragonato a una Luna giamai calante. 
Amplissimi... Pianeti: gli illustrissimi senatori sono simili a stelle fisse e gli spettabili magistrati a pianeti erranti: quelli erano inamovibili, questi invece potevano essere trasferiti.
sevitie: crudeltà.
arte e fattura diabolica: è il primo cenno a quella soverchiante, irrazionale superstizione che tanta parte avrà nel romanzo, specie nel racconto della peste.
attesochè: dato che.
occhij d'Argo e braccj di Briareo: mostri mitologici forniti, rispettivamente, di cento occhi e di cento braccia. 
pubblici emolumenti: il pubblico guadagno.
Per locchè: per cui.
verde staggione: gioventù. 
tributarij delle Parche: abbiano pagato, morendo, il loro tributo alle Parche (divinità della mitologia greca da cui dipendeva il destino umano).
degni rispetti: il rispetto dovuto ai vivi, al familiari.
generaliter: in modo generico (latino).
Parto: opera.
purissimi accidenti: nella filosofia scolastica allora dominante si distinguevano sostanza (ciò che è essenziale) e accidenti ( ciò che è variabile e non necessario). Il discorso è troncato, ironicamente e maliziosamente, su una parola che per noi ha tutt'altro significato. La pagina trasuda un cielo iperbolico e adulazione dei potenti, alte sfere di cielo iperbolico dove il sole «mai tramonta» e la luna è giamai calante», dove stelle fisse e pianeti spandono luce «per ogni doue»: tanto splendore innaturale sembra inebriare la corta intelligenza dell’anonimo, il quale dà fondo a tutte le risorse retoriche per inneggiare, paradossalmente, a coloro che si dimostrano impotenti di fronte a «malvaggità e sevitie che dagl'huomini temerari si vanno moltiplicando»: donde la conclusione che il male storico sia «arte e fattura diabolica». Si valuti con attenzione il tono nient’affatto scherzoso di questa splendida invenzione manzoniana: la falsa religiosità si finge streghe e diavoli (e untori) come comoda giustificazione dell’inettitudine e dell’iniquità, vere cause delle tragedie del Seicento. Ironia amara che rovescia sottilmente la pomposità barocca dell’eloquio, mostrandone la vacuità morale e trasformandola in un implacabile atto d’accusa.
dilavato e graffiato: stinto e pieno di sgorbi.
di concettini e di figure: di pensieri astrusi e di immagini retoriche.
virtù: abilità, virtuosismo.
Idiotismi lombardi: espressioni dialettali lombarde.
a iosa: in abbondanza.
eleganza spagnola: spagnolismo (è detto co ironia).
affettato: ricercato, manierato.
solecismi: sgrammaticature.
in questo paese: in Lombardia.
Meno male... lavo le mani: Il Manzoni contesta, innanzi tutto, la lingua e lo stile dell’anonimo secentista, con le loro acutezze e gli ornamenti ridicoli, rivolti più a eccitare la meraviglia che a narrare oggettivamente i fatti: una mescolanza di rozzezza e di cattivo gusto. Rifiutare un siffatto uso della lingua significa, ovviamente, prendere le distanze da una cultura, da una visione della vita, da una concezione religiosa e morale che lo scrittore moderno sente come false e innaturali, lontanissime dal pubblico cui intende rivolgersi. Emerge, qui, il rapporto essenziale fra l’artista e i destinatari di una letteratura popolare (in senso romantico), utile e interessante, alla cui nascita è tuttavia necessario uno strumento linguistico nuovo e affatto sconosciuto alla paludata tradizione retorica della nostra letteratura, come mostra l'esempio negativo della scrittura barocca.
dicitura: espressione. 
Non essendosi presentato: osserva la mancata concordanza del participio col nome. 
pari all'importanza: vuol dire, maliziosamente, che l’ingenuità è poca, quanto l'importanza del libro. È come dire che egli non pensa che i lettori credano all’invenzione del manoscritto.
E, all'occorrenza... tentato di negarla: Manzoni si informò scrupolosamente sulle condizioni storiche del Seicento, per dare - secondo la sua poetica romantica — un fondamento di verità alla “bella” ideazione narrativa. Viene impostato il problema cruciale del rapporto fra storia e invenzione artistica, che caratterizza tutta l’opera dello scrittore milanese (si ricordino, ad esempio, le prefazioni al Carmagnola e all’Adelchi). Quanto alle fonti da cui egli attinse spunti, notizie e in genere tutto ciò che concorre a formare il colore storico del romanzo, ricordiamo in primo luogo le opere di Giuseppe Ripamonti e di Alessandro Tadino, più volte citate nel corso del racconto. Si noti, in queste righe, l'attitudine etico-religiosa, oltreché intellettuale, del Manzoni nei riguardi della storia del Seicento, e più in generale della storia di ogni tempo: «a ogni passo ci abbattevamo in cose consimili, e in cose più forti». È il primo manifestarsi, ancora in sordina, di un sentimento di radicale riprovazione delle iniquità e delle violenze perpetrate spesso in nome di valori ipocriti e vuoti: a tanto si riducono le leggi, l'ordine, l’onore, la scienza, la cultura e la politica in un'età che esibisce una religiosità tutta esteriore e formale, povera di autentiche risorse spirituali. Ma si ricordi che per l’austero ed esigente giansenismo manzoniano la storia, abbandonata ai suoi impulsi materiali, è sempre negativa, caotica e insensata. E tuttavia — contraddizione inevitabile — l’uomo non può e non deve sottrarsi alla condizione storica, ad incarnare nel tempo la sua inquieta e tormentata esistenza.
contingenti: possibili, eventuali.
le mandavamo insieme a spasso: nota la scherzosa personificazione delle critiche opposte che, persa la punta della polemica con il semplice accostamento, vengono sbrigate e mandate a spasso.
Ma che? quando siamo stati... venivano a fare un libro: Il problema della lingua con cui scrivere un romanzo moderno assillò per molti anni il Manzoni che, com'è noto, scelse quale modello letterario il fiorentino borghese, parlato dalle persone colte. A varie riprese egli confortò questa soluzione con numerosi scritti teorici, che ebbero una notevole importanza politico-culturale nel dibattito ottocentesco sulla questione della lingua italiana. L'argomento era puntualmente affrontato nella seconda introduzione al Fermo e Lucia, dove il Manzoni scriveva: «Quando l'uomo che parla abitualmente un dialetto si pone a scrivere in una lingua, il dialetto di cui egli s'è servito nelle occasioni più attive della vita, per l’espressione più immediata e spontanea dei suoi sentimenti, gli si affaccia da tutte le parti, s attacca alle sue idee, se ne impadronisce, anzi talvolta gli somministra le idee in una formula; gli cola dalla penna e se egli non ha fatto uno studio particolare della lingua, farà il fondo del suo scritto. Di questo colore municipale si è fatto in vari tempi rimprovero a molti scrittori: che deturpasse gli scritti non v'ha dubbio: quanto agli scrittori, prima di rimproverarli così acremente si sarebbe dovuto pensare che non è cosa tanto facile prescindere da quelle formole alle quali sono unite per abito tutte le memorie, tutti i sentimenti, tutta la vita intellettuale [...]. Che giova dissimulare? Confessiamo sinceramente che anche noi abbiamo adoperata qua e là, non solo nei dialoghi, ma anche nella narrazione qualche parola, qualche frase assolutamente lombarda». Già nell’edizione del 1827 (detta “ventisettana”) la scelta del fiorentino è ormai sicura: nel lungo intervallo che precede l'edizione definitiva del 1840-42 (detta "quarantana”), Manzoni verrà rafforzando i suoi convincimenti linguistici che lo porteranno alla minuziosa revisione stilistica del capolavoro.
