L'Historia: L’Historia. Quest'introduzione non è da saltare, come molti fanno, perchè è importante e assai arguta. Fu fatta a similitudine di quella del Cervantes, ma con altra base. L'A. vuol dare ad intendere d'aver trovato il manoscritto d'un romanzo, molto bello, che ebbe desiderio di pubblicare; ma a un certo punto s'accorse non esser quella una forma possibile : bisognava correggere e rifare. Perché il lettore se ne persuada meglio, glie ne porta subito un saggio; che è questo brano in corsivo. Finge d'avere smesso a un certo punto; e fa delle riflessioni sulla prosa del sopposto anonimo secentista, le quali intendono essere una critica di tutt’ una maniera di scrivere, e un insegnamento generale di quant'occorre per scrivere discretamente. Insomma un piccolo trattato dell'arte del dire, tanto piú importante a' tempi del Manzoni, che, in quanto a criteri di lingua, c'era una confusione tale da non poterla immaginare un giovino che venga su ora, che tanti impacci furono sgombrati da lui. E si noti. Il brano imitato e virgoleggiato è tutt'una goffaggine per la forma; ma per la sostanza è buono: è il Manzoni che paria, camuffato da secentista. Eccone qui il senso: - La storia sa eternare i fatti umani; ma gli storici non parlano che dei principi e dei potenti. Le mie deboli facoltà non mi permettono di sollevarmi tanto alto (v. la Vita che precede il volume), Avendo avuto notizia di fatti importanti avvenuti a dei poveri artigiani, racconto questi. E si vedrà in breve racconto, scene veramente triste, vere tragedie, azioni che si potrebbero dire diadoliche. E se non ci fosse entrato il diavolo (Don Alessandro fa, al suo solito, della satira) come potrebbe darsi che un impero così felice come il nostro, retto da un re cattolico, da un viceré, da tanti magnifici senatori, da rispettabili magistrati, riuscisse a  diventare campo di tante ingiustizie? Ora,  io descrivendo le cose avvenute quand'ero giovine, benché la piú parte delle persone di cui parlo sian morte, pure, per degni rispetti,  ne tacerò il nome, indicando solamente in  generale i territori. E nessuno, che ragioni un po’, me ne farà colpa, perché, in quant’alla sostanza, non manca nulla; e i nomi sono puri purissimi accidenti. - Non staremo a dire qui in particolare le ragioni imitatorie di questo brano contraffatto: il preuderia ab ovo; il cominciare da una definizione, secondo il consiglio ciceroniano; il  soffermarsi tanto su una stessa similitudine, rincalzandola trivialmente con altre della stessa goffaggine; quell'imbastitura d'allori, di prigionieri, di cadaveri, di spoglie, d’imprese imbalsamate cogl’inchiostri, ecc. Lo studioso rifletta da sé. 
solleuarsi: sollevarsi. Correz. fatte  per avvicinarsi meglio alla scrittura del  secento. 
le sole spoglie: le spoglie. L'aggiuuta forma un di quei bisticci cari anticam. a' provenzali, e non discaro a' tempi che finge l'A. 
si suol dire: suol dirsi. Meno com. 
troverà poi: troverà egli poi. L'egli piconastico è oggi meno com. e piuttosto volgaro. 
decifrare: deciferare. Oggi contadinosco. 
dicevo tra me: diceva io fra me. La desineuza avo, eva, iva nelle prime pers. dell’imperf. è equivoca; e non è che nell'uso letterario. Correggendo coll'uso, qui l'io diventa inutile. 
grandine: gragnuola. Non vivo quasi piú che nel prov. Socera e nora tempesta e gragnola. E non si userebbe coll'u. 
secentista: (non seicentista) scrittore del secento, cioè del sec. xvii. 
sul principio mettero in mostra la sua virtù: a prima giunta fare un po’ di mostra della sua virti. Quell’A prima giunta è poco com., e avrebbe senso di a prima vista, con idea piú d'arrivo, che di principio. Metter in mostra è piú ampio; e dice meglio l'ostentazione. 
com'è: come è. Questi troncamenti, sia detto una volta per sempre, sono per agevolare il legame delle parole, come quando si parla. In quanto alla critica, osserva che il M. intende s'abbia a scrivere con semplicità, senz'affettazione; ma non non dozzinalmente e con goffaggini. L'arte à le sueeno prerogative; e tra le prime, quella di non andare a caso nella scelta delle parole, e di evitare le sciatterie. Si va a caso quando l'espressione non è calzante; e sciatteria c'è sempre in arte quando caschiamo nel superfino di parole e d'idee e ne’ così detti luoghi comuni. Anche la rettorica ci vuole, ma discreta. E va faggita la grammatica arbitraria cioè quella che è in disorienta coll'uso. Così i periodi sono sgangherati quando non son fusi dall'arte, eliminando quanto s'è detto sopra. Metti insieme quanto il M. critica al suo supposto anonimo; e vedrai quello che occorre per avviarsi a scriver bene. 
a iosa: a furia. In questo sign. non usa. 
spagnola: spagnuola molti di questi u sono scomparsi  dall'uso, e oggi anche nella scrittura com., riavvicinandosi cosi, în fondo, all'ortografia latina. 
a: ad. Una volta si metteva  questo d eufonico a molte particelle; e si faceva ched, mad, sed ecc. Gli ultimi a scorparire sono stati od, ad, ed, i quali non s’adoprano che raramente; p. e. Adamo ed Eva, Dare ad intendere e pochi altri. Ma Od è scomparso, o quasi. 
richiedono: richieggono. D'uso piú volgare che com.
rettorica: retorica. Uso. 
fine: fina. Uso. 
metterci: mettervi. Uso meno com. 
opposte: disparate. Assai diverso: il disugualo non è l'opposto. 
la maniera: modo. ll modo indica piú arte e finezza; e s'addice meno allo sciatto anonimo. 
ammaliziati: avvisati. Aveva un sign. d’accortezza cho non è piú nell'uso. E ammaliziati dice la furberia di chi sa sfuggire i tranelli, specialmente comuni e volgari, come il M. vuol far credere il suo. 
Meno: Manco. Uso.
era parsa bella: ella era paruta. Paruta non usa piú; ella non è com.; il bella, ripetuto, afferma meglio la persuasione delI’A., il quale dice cosa molto giusta. Chi non è persuaso che il suo lavoro sia buono e bello non lo deve pubblicare. Ingannarsi, pazienza; ma ingannare, no. 
alcuna obiezion: alcun perché. Il perché non era un’obiezione. Qui il troncamento d’obiezione non saprei dirlo necessario; o presentata tornava forse meglio. 
subito: tosto. Uso. 
un'ingenuità pari: Qui il M. sì burla un poco del lettore disattento, perché intende dire appunto che quanto à raccontato finora, circa all’origine del libro, è tutt'una bella fandonia. Ma, vien voglia di domandare, se l'A. dice sopra che il romanzo gli pareva bello, perché ora gli nega importanza? Arguto lettore, son due cose abbastanza diverse. 
testimoni: testimonii. Questi due ii non si fanno sentire nella maggior parte di questi nomi (v. mio Vocabolarietto di pronunzia e ortografia) e dove non si pronunziano, neppure si segnano scrivendo. 
messi a frugar: data la briga di frugare. Darsi la briga è da impacciosi; o di chi non abbia sufficienti ragioni per fare quel che fa.
fossero: avessero. Uso. 
rifar l'opera altrui: rifare l’altrui lavorando. Uso. E poi Lavorio è ben diverso da opera e da lavoro. Indica qualche cosa di speciale e di travaglioso, mentre qui si parla in generale. 
avevam proposto: noi ci eravamo proposti. Quel ci eravamo è meno modesto, 
con: coll: Anche questo. Perché coll’, indica intenzione piú piena. 
questioni: quistioni. Meno com. 
alle mani tra: a’ capelli fra. La frase sostituita corrisponde meglio col battere che segue. 
a fondo: addentro. Dice meno. 
tutt'e due: entrambe. Uso. 
badare ai: avvertire i. Avvertire vien da badare, che, secondo il parere dell'A., qui basta. 
messole: postele. Uso piú comune. 
ci: vi. È piú letter. che com. 
al punto: a quello. Uso. 
Veduta la qual cosa: Il che veduto. Qui la ragione del cambiamento o non e' è, o è poca cosa, perché anche la qualcosa è lett. Forse a' tempi del M. il che era piú letterario che oggi. 
abbiam messo da parte: ponemmo da canto. Uso. 
buone: valide. Il valide accenna a un’esuberanza di forza che forse è Superflua per una storia e una questione di così poca importanza, come dice l'A. E buona è la parola usata comunem. Nella fine di questa Introduzione il M. accenna già alla questione sulla lingua che aveva in mente di trattare, e che poi trattò col buon successo che tutti sanno. Nessuno meglio di lui, nel comporre e correggere con una precisione cosi minuziosa il suo romanzo, poté veder da vicino le particolarità noiose e i guai cancrenosi di quella lingua aerea che in tutte le città d'Italia si trovava, senza risedere in alcuna; e poté con sicura coscienza di quel che faceva, dare contro a un'infinità di nemici una battaglia di tanta importanza.
