Quel ramo: Il lacco di Como alla punta di Bellagio si divide in due rami, l'orientale verso Lecco, l’occidentale verso Como: qui si parla del primo, donde l'Adda rincomincia.
sparse di terre, cioè di paesi: forse più chiaro sarebbe sparsi, perchè si riferisce anche a campi.
e che s'incammina a diventar città: Ormai è diventata, fiorente d’industrie e di commerci; e ha inalzato al Manzoni un bel monumento, del Confalonieri.
l'onore d'alloggiare: È il primo accenno ai mali della dominazione straniera: spagnola ai tempi del racconto, austriaca ni tempi che il Manzoni lo scriveva.
e da qui la vista spazia: Tutta questa descrizione dal vero è di grande evidenza; ma specialmente di qui in giù, dove con stupenda semplicità è ritratto il continuo variare dello spettacolo. La nostra letteratura non aveva prima del Manzoni descrizioni di paesaggi o spettacoli di natura, che fossero parte di una gran concezione poetica, e con questa intimamente connesse, non esterne e puramente esornative. Egli «rese immortali nell’arte monti e laghi, che, pur nella terra della poesia, non avevano avuto da secoli il loro poeta» (Zumbini).
degradando: 1ª ed. digradando.
non si trovan nel manoscritto: quanto alle persone, «per degni rispetti», come diceva l’anonimo nell’Introduzione; quanto ai luoghi, è il Manzoni che non vuol fissarli per motivi d’arte, come vedremo.
Diceva tranquillamente: Nota come ogni particolare, ogni mossa di don Abbondio descrive un nomo abitudinario, tranquillo, senza preoccupazioni, senz’altro pensiero che di recitare, passeggiando, il solito ufizio. Ne ha così maggior rilievo lo spavento del brutto incontro che ora leggeremo.
sul quale eran dipinte certe figure: Ci pare d’averlo visto co' nostri occhi questo ingenuo affresco; anche perchè ne abbiam visti ne' tabernacoli di campagna tanti che lo somigliano.
Fino dall'otto aprile: Queste citazioni dei bandi o gride contro i bravi parvero «lungaggini» a più d’uno e anche al Tommaseo che afferma: «bastava citare i fatti senza citare i decreti ». Ma leggi attentamente e vedrai come proprio dalla citazione letterale dei decreti, dai titoli pomposi dei governatori spagnoli, dalle loro sempre inutili e sempre ripetute severissime comminazioni, risulta l’alterigia di quel governo e insieme la sua impotenza davanti ai prepotenti; impotenza messa anche più in rilievo dalla esorbitanza delle pene minacciate e lasciate all’arbitrio senza limiti degli esecutori. E questi vedremo che gente fossero, generalmente. Vedi più oltre (p. 14 e sgg.), dove è descritto in quali tempi a don Abbondio toccò a vivere.
onninamente: in tutto e per tutto.
Enrico IV: di Francia, prima re di Navarra (1553-1610), donde «navarrini» per indicare i suoi sudditi e poi in generale i francesi; vedi al cap. V, p. 65, n. 27.
a cui fece perder la testa: nel senso letterale della frase.
la stampassero ad esterminio de' bravi: Se fosse bastato stamparla!
neppur di quelli: di quei colpi.
un anno, un mese e due giorni: «Tale specificazione della data è una vera futilità», sentenzia un chiosatore. Chi sa leggere sente che non è cosi : si tratta dell’ultima grida prima dell’incontro, di quella che era, come oggi si dice, in vigore, e che perciò doveva far più paura ai bravi; ed è naturalo che le due date, della grida e dell'incontro, siano precisate e avvicinate con un sorriso.
stessero ivi: Quest’«ivi» è di più, e non è parola dell’uso.
a un tratto da mille pensieri: da mille pensieri in una volta, tutti insieme, in questo senso a un tratto non riesce chiaro, o doveva esser posposto, come poco sopra nelle parole «tutt'e due a un tratto».
se... ci fosse qualche uscita di strada: per un’ultima speranza che i bravi svoltassero.
il testimonio consolante della coscienza: C’è anche qui un po’ d’ironia. Si suol dire che quel testimonio basta a dar coraggio: ma non sempre nè a tutti, specialmente ai don Abbondio. Di più, non c’era da supporre che un tal uomo avesse peccato «contro qualche potente, contro qualche vendicativo»!
più modesta: È facile capire perchè. 
non desiderava altro che d'abbreviarli.: Accade a tutti in momenti come quelli.
a voce più alta: per farsi coraggio e per mostrarsi sicuro di sè.
Cioè...: Con questo cioè il povero prete ha già tradito la sua coscienza e ceduto ai prepotenti; e peggio dove aggiunge «fanno i loro pasticci tra loro».
come... un lampo: Lo similitudini manzoniane son tutte, come questa, d’una mirabile evidenza. Quel nome illumina il disgraziato, ma gli raddoppia lo spavento.
se mi sapessero suggerire... A questo è ridotto! a chiedere ai bravi quale scusa potrà trovare per levarsi d’impaccio.
a lei che sa di latino: In bocca al bravo è un’ironia sguaiata; ma don Abbondio tenterà davvero d’ingannare Renzo col latino, come leggeremo nel secondo capitolo.
chiudendo il libro: Dunque era stato, durante tutto il dialogo, col breviario aperto sulle due mani, come sur un leggio. Bisogna vederlo così perchè la scena, tra comica e pietosa, abbia tutto l’effetto.
dond'era lui venuto: lª ed. dond’egli era venuto. Meglio lui, ma doveva esser posposto: dond’era venuto lui.
d'esser divorato: lª ed. ad esser divorato.
i privilegi d'alcune classi: specialmente dei nobili, degli ecclesiastici e dei militari.
incaricati dell'esecuzione immediata: i birri.
le sue immunità: come l'esenzione da certe tasse, il diritto d’asilo inviolabile nelle chiese e nei conventi, e simili.
i medici stessi: Perché i medici stessi? Forse perchè il medico, come il prete, dovrebbe sempre tenersi libero da quei vincoli. Secondo il Bellezza, perchè le competizioni e le discordie son più facili e comuni tra i medici.
come un vaso di terra cotta: La similitudine riassume mirabilmente tutta la precedente analisi di quella società, dove i «pacifici» e i «deboli» erano alla mercè dei prepotenti e dei violenti; e non serve soltanto per il caso di don Abbondio. Ne avremo la riprova in tutto il libro.
Aveva... ubbidito ai parenti: Lui volentieri; la monaca di Monza per forza, come vedremo: ma in tutt’e due i casi i genitori impongono la loro volontà senza averne il diritto. Nota che qui, come altrove, il M. usa «parenti» nel senso di genitori.
un po' fantastico: un po’ strano o lunatico.
perché la ragione e il torto: Gran verità, che spiega come mai certe questioni durano ali’infinito: chi ha torto ripete sempre quel po’ di ragione che resta dalla sua parte, e non si rassegna a cedere.
ch'era un mischiarsi nelle cose profane: Don Abbondio lo diceva a scusa della propria viltà; ma è una vecchia e abile accusa sempre rimessa a nuovo contro quei preti che credono d’aver qualcosa da fare anche fuori di sagrestia.
una sua sentenza prediletta: L’aveva; ma da questo momento non la dirà più!
i miei venticinque lettori: vuol dire i miei pochi lettori; ma questa sarebbe stata una frase banale: quel numero, del quale non vedi la ragione precisa, le dà grazia e novità.
Ragazzacci, che... non si fanno carico: Nota qui, e poi sempre, come la paura di don Abbondio è insieme anche egoismo.
a portar la loro imbasciata: Era per concludere: agli sposi; ma se ne vergogna a tempo.
l'età sinodale dei quaranta: cioè i quarant’anni prescritti dai sinodi diocesani perchè una donna possa stare al servizio di sacerdoti. Nello poche parole che seguono vedi come è vivo e vero il ritratto della « zittellona».
o è cosa che non posso dire: Ha già fatto il primo passo, o ormai si capisce che dirà tutto.
con voce commossa: Nella insistenza di Perpetua si mescolano in parti uguali un sincero interessamento per il padrone e una gran curiosità di saper il segreto.
Son pareri codesti: Ma i pareri di Perpetua gli torneranno a mente un giorno!
con licenza, a...: Si capisce che l’immagine non doveva esser troppo conveniente; sul tono di calar le brache che segue subito dopo. Perpetua «è di prima impressione, dice tutto senza rispetto alcuno: vivace contrasto con don Abbondio, il quale è tutto prudenza, tutto riguardi, tutto cautele» (De Sanctis).
Giunto su la soglia: Fa sorridere, ma fa anche un po’ compassione. Accade a tutti qualche volta nella vita di sentirci un po’ don Abbondio; il quale perciò in generalo non ci parrà repugnante, anzi non di rado finiremo per compatirlo pensando «Chi è senza peccato....».
