Quel... Como: il cosiddetto lago di Lecco, ben noto al M. che ivi presso (nella villa paterna del Caleotto) trascorse «gran parte della infanzia e della puerizia, e le vacanze autunnali della prima giovinezza », come è scritto nel Fermo e Lucia. 
a costiera: costa, spiaggia in pendio.
l'Adda rincomincia: l'Adda perde il nome di fiume formando il lago, lo riacquista uscendone al ponte di Lecco; poi lo perde di nuovo dando origine ai laghetti di Pescarenico, Cariate, Olginate e lo riprende definitivamente al termine di essi.
tre grossi torrenti: il Gerenzone, il Caldone, il Bione.
di terre, di ville: di borghi, di villaggi.
era... castello: era munito di fortificazioni.
tuttavia: tuttora.
Abbondio: è il nome del santo patrono di Como.
curato: per il M. sinonimo di parroco.
ufizio: uffizio (fior.). Cfr. più sotto ufiziali.
fessi: spaccature, fenditure.
guardia: o guardamano, è la parte dell’impugnatura che serve a riparare la mano.
come in cifra: come nel complicato disegno di un monogramma.
squarci autentici: tratti da documenti storici, non frutto di invenzione romanzesca.
gran Contestabile : altissima carica militare.
Sua Maestà Cattolica: Filippo il (1527-1598), re di Spagna dal 1555.
esercizio: attività di lavoro.
fargli spalle: spalleggiarlo.
grida: editto; ai tempi della dominazione spagnola, il termine indicava i provvedimenti legislativi emanati dal governatore, validi solo finché egli era in carica, salvo conferma del successore.
corda: tormento di frequentissimo uso sino al sec. XVIII; consisteva nel legare al condannato le mani dietro la schiena con una fune mediante la quale veniva poi sollevato da terra e tenuto qualche tempo sospeso o bruscamente lasciato cadere.
processo informativo: indagine istruttoria. 
galea: o galera, nave da guerra su cui i condannati trascorrevano ai remi il tempo della pena.
sbrattare: sgombrare.
appostatamente: proditoriamente. 
fautori: mandanti. 
onninamente: in tutto e per tutto (lat.). 
cabale: maneggi, intrighi.
Enrico IV: Enrico di Navarra (1553-1610), re di Francia dal 1589. Il Fuentes, durante il periodo del suo governatorato milanese, cercò di sollevargli contro ogni genere di ostilità.
il duca di Savoia: Carlo Emanuele 1 (1562-1630), duca dal 1580, sposò nel 1585 l’infanta spagnola Caterina; tre anni dopo occupò il marchesato di Saluzzo, quindi invase la Provenza e giunse a porre la sua candidatura al trono di Francia. In seguito fu però costretto ad accedere a una pace negoziata, lasciando ai Francesi un vasto territorio oltre il Rodano.
il duca di Biron: Carlo di Gontaut (1561-1602), duca di Biron, decapitato per aver cospirato contro il suo re, d’intesa con Carlo Emanuele.
stampatori regii camerali: i Malatesti avevano ottenuto nel 1603, e conservarono a lungo, l’incarico ufficiale di stampare i decreti della Regia Camera, organo di governo che presiedeva all’attività amministrativa e finanziaria.
Gonzalo Fernandez di Cordova: il suo governatorato durò dal 1626 al 1629.
a un tratto: qui e altrove, nel senso di insieme, a un tempo. Cfr. poco più oltre «fu assalito a un tratto da mille pensieri ».
il testimonio... coscienza: ironico: la coscienza, s’intende, di non aver peccato contro i potenti e i vendicativi.
del comune: della comunità, cioè di tutti.
messere: non è apostrofe sarcastica, ma titolo un tempo spettante ai sacerdoti.
aggranchiate: aggranchite, rattrappite.
naturale: carattere.
asili: chiese, conventi, dimore nobiliari, entro le quali la giustizia non poteva perseguire il malfattore che vi avesse trovato rifugio.
alcune classi: clero, nobiltà, militari, come specificherà più avanti.
Gli uomini... immediata: gli agenti di polizia, i birri o bargelli, come li chiama il M.
i medici stessi: forse perchè la tradizione li vuole sempre discordi e rivali; che, a o, più seriamente, perchè avrebbero dovuto fornire esempio di disinteressata dedizione alla loro opera umanitaria e godere dell’universale rispetto.
discrezione : discernimento.
parenti: qui e quasi sempre, per genitori (lat.). 
dissimulando: mostrando di non accorgersi.
fantastico: lunatico, bizzoso.
i miei venticinque lettori: iron., i miei pochi lettori.
la loro imbasciata: ... a Renzo e Lucia.
età sinodale: l’età minima di quarant’anni, prescritta dal Concilio di Trento (sinodo = assemblea ecclesiastica) per le donne che prestino servizio presso i sacerdoti.
legalo: stentato.
le gomita: i gomiti (tosc.).