Quel ramo: il ramo orientale, che volge verso Lecco. Nel parlare del ramo del lago come di cosa nota (Quel ramo...) si percepisce sottesa, una trama di ricordi che, nella prima stesura del romanzo, il Fermo e Lucia, Manzoni rievocava espressamente, dicendo dell’infanzia e della prima giovinezza trascorsa in quei luoghi, nella villa paterna del Caleotto, presso Lecco. C’è dunque un affetto colorato d’idillismo (e sulla presenza di un elemento idillico almeno nella prima redazione, cfr. C. VARESE, «Il M. e la poetica dell’idillio», oggi in Fermo e Lucia, un'esperienza manzoniana tee., Firenze 1964, pp. 133-152) che occorre tener presente. La sottigliezza e precisione dei particolari rispondono al modo tipico manzoniano di porsi di fronte alla realtà; ma non si deve insistere sulla scrittura in sé. Il passo non è una diffusa «cartina geografica» (C. Angelini), anche se non manca, tutt’altro, un’accuratezza ripetutamente calcata; meno ancora una specie di stampa di gusto secentesco. Vuol essere un modo manzonianamente scrupoloso di familiarizzarci con l’ambiente del racconto, cominciando dal «contenitore» paesistico in tutte le sue dimensioni, gradazioni, connotazioni prospettiche, e dalla localizzazione storica.
monti: le Alpi Orobie e i monti della Brianza.
e l'Adda rincomincia: l’Adda entra nel lago di Como a nord presso Gera, e si riforma a sud uscendo dal ramo qui descritto, per riprendere poi forma di lago a Garlate e Olginate. Da rilevare nella sintassi della pagina la trama degli enunciati che «rallentano o accelerano la velocità della frase», nonché le simmetrie interne e le figure chiastiche («a seni e a golfi», «in nuovi golfi e in nuovi seni») che movimentano la frase (su ciò, cfr. il commento al romanzo di E. RAIMONDI e L. BOTTONI, Milano 1987). La verità è che Manzoni finalizza la scrittura all’intento strutturale e al decorso narrativo. Di qui, l’interna mobilità, l’accelerazione e la varietà soggiacenti nella prosa.
tre grossi torrenti: il Gerenzone, il Galdone e il Bione.
terre: borgate.
un castello: una fortezza tenuta da una guarnigione di soldati.
piglian: ricomprendono.
campeggia o si scorcia: appare in piena prospettiva, oppure di scorcio. A questo punto, nel Fermo e Lucia seguivano compiaciuti particolari d’indole botanica.
vi si rappresentava sulla costa: si noti lo svilupparsi graduale dei tratti, via via dal piano prospettico generale all’enumerazione dei punti del paesaggio; e l’affiorare (qui e soprattutto avanti) di un colorito affettivo, in corrispondenza con «l’intenso, casto amore manzoniano per la malinconica bellezza del suo mondo lombardo» (G. PETROCCHI, «Commento al cap.», in Letteratura, IX, 51, maggio-giugno 1961, n. 6).
del giorno 7 novembre dell'anno 1628: un giorno di mercoledì; il riferimento cronologico sarà puntualmente tenuto fermo nei successivi eventi, come, quattro giorni dopo, il tumulto a Milano del giorno di san Martino.
don Abbondio: nome diffuso nella zona, essendo sant’Abbondio il patrono della città di Como.
fessi: fessure, spaccature. Ci fu chi osservò che il particolare è inadatto e non ben legato con quel tanto di sensibilità che poteva avere don Abbondio. Ma l’immagine delle pezze di porpora, non poi così peregrina, coglie con esattezza la tonalità vivida e fredda dei colori di un tramonto di tardo autunno.
il breviario: il libro liturgico che contiene l’ufficio recitato dai sacerdoti.
cura: la chiesa con l'annessa canonica, sede del curato.
guardia: quella parte dell’impugnatura che serviva a difendere la mano dai colpi.
Sua Maestà Cattolica in Italia: come si è visto nell’Introd., Filippo IV di Spagna.
per fargli spalle e favore: per proteggerlo e aiutarlo.
esser posto alla corda: tortura che consisteva nel sollevare il condannato, mediante un sistema di carrucole, per le braccia legate dietro la schiena, fino a spezzargliele con reiterati tratti.
processo informativo: processo basato non su prove, ma su indizi e supposizioni. Erano i metodi procedurali, tortura per primo, contro cui protestò il BECCARIA nel libro Dei delitti e delle pene (1764).
galea: galera.
appostatamente: mediante appostamenti, o agguati.
onninamente: in tutto e per tutto.
Governatore dello Stato di Milano: governatore dal 1600 al 1610.
comminazioni: minacce ai trasgressori della legge.
cabale: intrighi, inganni.
Enrico iv: Enrico iv, re di Francia dal 1589 al 1610.
il duca di Savoia: fu infatti il governatore di Milano, don Pietro Enriquez de Acevedo, che indusse Carlo Emanuele i, duca di Savoia (1580-1630), ad impossessarsi del marchesato di Saluzzo che era stato assegnato alla Francia nel 1559. Più tardi, però, Enrico iv sconfisse il duca sabaudo e, col trattato di Lione (1601), gli lasciò il marchesato, imponendogli nello stesso tempo la cessione di vasti territori transalpini.
a cui fece perder la testa: Charles de Gontaut, duca di Biron (1562-1602), fu uno dei migliori generali di Enrico iv; ambizioso e instabile, indotto dal de Acevedo, s’intese con Carlo Emanuele I contro il proprio re. Scoperto, scontò sul patibolo il tradimento.
stampatori regii camerali: stampatori per conto della Regia Camera, ovvero fisco o cassa dello Stato.
se qualcheduno arrivasse: sono i primi tratti dove il gusto della notazione manzoniana del reale prende a districarsi; perciò il discorso può sembrare rallentato e qua e là macchinoso. Si noti peraltro che vuol dipingere quel che d’impedito ed esterrefatto è nel gestire di don Abbondio.
Renzo Tramaglino e Lucia Mondella: i nomi convengono perfettamente ai due personaggi, sia per l’ambiente dove son nati, sia per l’intimo carattere. Mentre, infatti, si può dire che quello della fanciulla «evoca un paesaggio tutto mondizia e luce», il cognome Tramaglino conviene a chi è nato e cresciuto alla seconda sorgente dell’Adda, derivando da «tramaglio», rete speciale usata per la cacciagione (C. ANGELINI, Manzoni, Torino, 1942, p. 105). Sull’onomastica manzoniana si vedano i ripetuti, interessanti richiami per i nomi femminili a quelli del Canone della Messa (così, nell’ordine del Canone, Perpetua, Lucia, Agnese, Cecilia, Felicita — che nel Fermo e Lucia è la serva poi anonima del leguleio, che restituisce a Renzo i capponi — e infine Perpetua). In proposito, dopo il Baldini, e poi diffusamente l'Angelini, si leggano le notazioni del CONTINI («Onomastica manzoniana», in Corriere della sera, 20 ag. 1965) e del DE MICHELIS (in Nuova Antologia, fase. 1989, sett. 1966, pp. 9-27).
del comune: della comunità, cioè di tutti.
don Rodrigo: nome spagnuolo. Il cognome non figura nel romanzo.
che non voglio trascrivere: non vuol trascrivere dal manoscritto dell’anonimo, che fa qui la figura d’imperturbabile resocontista.
aggranchiate: irrigidite come da un crampo per la paura.
gli asili: i luoghi come chiese, conventi, palazzi di nobili ecc., dove i malfattori si rifugiavano per trovarci, con l’ospitalità, l’immunità.
e il loro titolo un improperio: birri o sbirri, termine rimasto fino ai nostri giorni nell’accezione spregiativa.
immunità: dispense da carichi civili e fiscali, 
privilegi: concessioni speciali in evasione alla legge comune.
esenzioni: esenzioni dalle tasse.
della discrezione: del discernimento.
e gridare a torto: la voglia d’essere bislacco e lunatico, e di fare a sua volta il prepotente strepitando a torto.
i miei venticinque lettori: espressione d’arridente modestia, divenuta proverbiale; che in fondo, secondo un’arguta notazione del BALDINI, si concilia al gusto manzoniano di un discorso intimo, conveniente a pochi ascoltatori fidati (cfr. in Quel caro magon di Lucia, Microspie manzoniane, Milano-Napoli 1956, p. 165 sgg.).
l'età sinodale dei quaranta: i quarant’anni prescritti dai concilii diocesani («si nodi») come età minima per le domestiche degli ecclesiastici.
celibe: nubile.
come dicevan le sue amiche: si noti l’ironia del termine amiche.
il nostro arcivescovo: il cardinale arcivescovo di Milano, Federigo Borromeo.
e disparve: il dialogo tra il curato e la serva è articolato meccanicamente, quasi auscultato dallo scrittore e via via tradotto dall’uso dialettale. Comunque, risponde proprio così a quel che di abitudinario e banale c’è nello scambio di battute fra i due attempati conviventi.