1. Quel ramo... seni: la celebre descrizione del ramo di Lecco di questo primo periodo, come di tutta la sequenza descrittiva di apertura, sembra obbedire alla esigenza di particolarizzazione che deve avere il romanzo. Nel saggio Del romanzo storico, confrontando il modo di rappresentazione del romanzo rispetto alla storiografia Manzoni spiega ciò nel confronto tra carta geografica e carta topografica dove sono “segnate anche le alture minori, e le disuguaglianze ancor meno sensibili del terreno, e i borri, le gore, i villaggi, le case isolate, le viottole”. È stata anche rilevata dalla critica una certa affinità, nel modulo descrittivo, con una pagina del gesuita secentesco Daniello Battoli (1608-85), molto letto nelle scuole e sicuramente noto a Manzoni: “Quella parte dell'India che è presso il Gange... e verso il mezzodì si sporge con una lingua, che dalle due foci dell'Indo e del Gange, onde comincia, è lunga presso dì novecento miglia” (Istoria della Compagnia di Gesù). Un’altra possibile fonte, sempre di provenienza dalla cultura scolastica di Manzoni è stata indicata da P. Marco Tentorio (Dissertazioni sul Manzoni, Genova, Archivio PP. Somaschi, s.d.) nel testo agiografico Vita del B. Miro del padre somasco Giuseppe Stampa (1666-1734): «Quella parte di Lombardia che verso il settentrione sollevasi poco sopra a Milano in amene colline... e si stende fin sotto ai monti, che formano una catena fra Como e Lecco, è la più felice e deliziosa di tutte le altre province che le stanno intorno, per essere popolata di grosse terre e villaggi, bagnata da larghi fiumi che serpeggiando fra quelle valli vi stagnano, e formano molti laghi... lingua di terra, che poi divide lo stesso lago di Como in due rami, l’uno dei quali conserva il nome generico, e termina a Como stesso, e l’altro sotto altro nome pon fine a Lecco e, da questo famoso borgo s’appela il ramo di Lecco.»
2. costiera: il pendio tra i monti e la sponda del lago.
3. tre grossi torrenti: Gerenzone, Galdone, Bione.
4. talché: cosicché.
5. contrassegno: indizio.
6. casali: case di campagna sparse sul territorio.
7. Lecco... città: allusione allo sviluppo della cittadina nell’800.
8. era anche un castello: sede di una guarnigione di soldati.
9. aveva... padre: è il primo periodo ironico del romanzo: la serie dei verbi (“aveva l’onore... e il vantaggio di possedere”; “insegnavan la modestia”; “accarezzavan le spalle”; “alleggerire le fatiche”) man mano mette a fuoco un significato antitetico al dettato linguistico, con ironica allusività, molto evidente nell’uso di “accarezzare” come “bastonare” e di “alleggerire” come saccheggiare”, in seguito ai soprusi usati con le ragazze e alle ruberie nelle campagne. E anche un primo rapido giudizio negativo su forze militari che invece di tutelare popoli e territori esercitavano la loro arbitraria prepotenza.
10. Dall'uria all'altra... vedute: la descrizione si cala all’interno del paesaggio, mettendo in evidenza stradina e cose offerte alla vista di chi vi transita, come appunto fra poco don Abbondio.
11. Per una... altrove: vi è voluta sfasatura ironica tra la precisione cronologica e l’indeterminatezza di luoghi e persona; riguardo quest’ultima Stefano Stampa (1819-1907), figliastro del Manzoni afferma (A. Manzoni, la sua famiglia, i suoi amici, Milano, Hoepli, 1885) di aver più volte sentito il patrigno sostenere che “le descrizioni di tutti quei luoghi marcati di un asterisco invece che dal nome, erano non solo immaginarie, ma fatte in modo e con l’intenzione di dérouter di sviare il lettore dal poterli riconoscere come realmente esistenti”. I paesi in questione sono comunque Acquate, date e Maggianico. Abbondio è il santo protettore di Como, per cui la scelta del nome obbedisce al color locale.
12. buttando... sentiero: è un puntuale dettaglio realistico, che connota anche un comportamento svagato e ozioso, espresso anche da altri avverbi del pezzo (“bel bello”; “tranquillamente”; “oziosamente”).
13. dov'era... giorno: il comportamento allude al carattere abitudinario del prete.
14. cura: la casa del parroco, cioè casa di don Abbondio.
15. nell'intenzion... vicinato: vale a dire che non si trattava di grandi pitture, al punto che ci voleva immaginazione per intendere le fiamme. L’effigie di devozione popolare e penitenziale è nel gusto figurativo dell’epoca e della Lombardia, in particolare.
16. bigiognolo: toscanismo che sostituisce il “grigiastro” del ’27; nel Fermo e Lucia era “bianco”, un colore troppo determinato in una cornice di indeterminazione e approssimazione.
17. Avevano... bravi: la descrizione del vestiario mescola esibizione degli strumenti di violenza con la pomposità del loro assieme, secondo il gusto secentesco. Bravo da pravus (lat., malvagio) indica il soldato di professione.
18. Questa specie... vitalità: comincia la digressione sulle grida, ovvero i bandi dell’autorità pubblica milanese contro i bravi, cioè contro l’uso di vari signori feudali di assoldare un piccolo esercito personale, in genere composto di figuri equivoci e loschi, capaci di soperchierie e sopraffazioni. Scopo della digressione è sia la documentazione storica (in modo assai più preciso di qualsiasi altro romanzo storico), sia l’ironia sottile nell’abile montaggio dei pomposi titoli nobiliari, del linguaggio legislativo secentesco solenne e perentorio, e totalmente inefficace, in quanto inanemente ripreso per mezzo secolo, senza conseguire alcun risultato (che avrebbe dovuto prodursi invece in pochi giorni).
19. Contestabile: o conestabile, capo di una giurisdizione militare.
20. Sua Maestà Cattolica: titolo del re di Spagna, nel 1583 Filippo II.
21. esercizio: lavoro.
22. stranamente: straordinariamente.
23. alla corda et al tormento: alla tortura della corda.
24. processo informativo: non documentato, ma solo su delazioni.
25. galea: nave penale, dove i condannati erano costretti a remare.
26. risoluta: decisa.
27. sette Infanti di Lara: famiglia aristocratica castigliana.
28. sbrattare: ripulire; argutamente Manzoni introduce un verbo pittoresco come sintesi efficace del contenuto della grida, scritto in tono aulico e burocratico.
29. malattie ostinate: corregge di nuovo ironicamente il contesto.
30. onninamente: soprattutto.
31. cabale: intrighi, soprattutto contro Enrico IV di Borbone, re di Francia (1589-1610) e teso a riconquistare il milanese.
32. duca di Savoia: Carlo Emanuele I, duca dal 1580 al 1630.
33. più d'una città: la conquista di Saluzzo comportò la perdita per il duca sabaudo di vari territori sul Rodano, ceduti alla Francia. La citazione storica serve a demistificare la forza di quelle trame, altro esempio del malo modo di gestire la politica del tempo.
34. duca di Biron: Charles Gontaut, generale di Enrico IV; accusato di tradimento, fu decapitato nel 1602.
35. stampatori regii camerali: tipografi delle stampe dello stato. La regia camera era la Cassa dello stato.
36. memorabile avvenimento: rincontro tra i bravi e don Abbondio; s’innesta ironicamente grande storia ufficiale con quotidianità.
37. sceleraggini: azioni delittuose.
38. galantuomini: detto ironicamente.
39. Renzo Tramaglino e Lucia Mondella: “nel dialetto milanese mondell designa il seme del grano bianco... Il cognome di Renzo sembra invece rifarsi a tremagg, foggia di rete da pestare o da uccellare, la quale è composta di tre teli di rete sovrapposti l’uno all’altro” (E. Raimondi - L. Bottoni). Possibili quindi le rispettive allusioni alla purezza e al lavoro del filatore.
40. comune: comunità.
41. a ciarle: a parole. I bravi rifiutano ogni discussione e ogni linguaggio; strumenti di cui diffidano perché non sanno usarli e preferiscono l’intimidazione senza appello e arbitraria.
42. Ma lor... ragionevoli: Abbondio tenta una vana captatio benevolente lodando iperbolicamente (con comico effetto paradossale) i suoi interlocutori.
43. oratore: detto con ironia ma distingue i due ruoli dei bravi: il primo espone, il secondo bestemmia e minaccia.
44. di latino!”: riprende l’atteggiamento sfottitorio, celato da finta sottomissione, verso chi usa la lingua e la cultura; nella malafede dei bravi il linguaggio colto serve solo a imbrogliare.
45. E, proferendo... serio: è una risposta di istintiva sottomissione e rassicurazione, al di là della stessa propria determinazione. Contribuisce a siglare la continua, assoluta e crescente pavidità del personaggio nell’episodio.
46. messere: signore.
47. dargli udienza: starlo a sentire, ma l’espressione di tipo solenne è sia ironica che emblematica del rapporto di forza superiore da parte dei bravi.
48. vessazioni: soprusi.
49. Tali... puntiglio: l’impunità riguardava soprattutto i luoghi religiosi inaccessibili alla polizia e alla legge secolare; ma anche importanti famiglie aristocratiche si impadronivano di quella franchigia, sostanzialmente con il consenso dello stato, in quanto i suoi reggenti erano membri di tali famiglie. Ne deriva un assieme caotico, che ha stimolato l’indagatore storico Manzoni. Sullo stesso registro scrive al Fauriel nel 1822: “Le memorie che ci restano di tale epoca presentano e fanno supporre uno stato della società veramente straordinario: il governo più arbitrario combinato con l’anarchia feudale e l’anarchia popolare; una legislazione stupefacente per ciò che prescrive e per ciò che lascia intendere o che descrive; una ignoranza profonda, feroce e pretenziosa” (Lettere, n. 160).
50. inceppare: impedire.
51. birri: la forza pubblica.
52. livrea: divisa da servitore.
53. costoro... improperio: lo scredito dell’esercizio della forza pubblica riprende il cenno in apertura sulla guarnigione di Lecco.
54. inazione: inattività.
55. nell'opprimer... difesa: secondo la legge manzoniana di rapporto tra oppressori e oppressi, espressa già nell'Adelchi.
56. arrolati: arruolati, iscritti.
57. facinorosi: pronti a fare il male.
58. dovizioso: ricco.
59. discrezione: giudizio.
60. fantastico: nel senso di fare un po’ lo strano rispetto al comportamento suo d’abitudine.
61. rigido censore: apposizione grottesca per don Abbondio, che è motivata dalla frustrazione di tanta sottomissione, sua imprigionante norma di vita.
62. torbido: ambiguo.
63. la ragione... altro: in questo caso la complessità dei problemi e delle questioni serve da alibi per lo scetticismo morale e per un rifiuto di responsabilità, requisito fondamentale invece dell’etica manzoniana.
64. confratelli: religiosi che svolgevano con impegno cristiano il loro ministero; la frase mostra l’assenza di autenticità religiosa del personaggio.
65. un voler... cani: “se intrigass de drizzà i gamb ai can” (C. Porta); l’espressione dà colore locale alla stizza di don Abbondio.
66. venticinque lettori: celebre e un po’ irritante formula di autoironia.
67. quell'altro: don Rodrigo, così apostrofato nella rabbia mentale del curato. Tutto il monologo è abilmente costruito per rendere linguisticamente, tra balbettamenti re", “e”, “e"), interiezioni (“ih!"), frasi sospese, esclamative e interrogative, espressioni di malcelata stizza (“Ragazzacci”; “quell’altro”) ecc., il ronzare “tumultuariamente" dei pensieri.
68. Non conosceva... la strada: Parini sul maestro di danza: “Egli all’entrar si fermi/ritto sul limitare, indi elevando/ambe le spalle, qual testudo il collo/contragga alquanto; e ad un medesmo tempo/inchini ’l mento, e con l’estrema falda/del piumato cappello il labbro tocchi” (Mattino, 172-77).
69. Perpetua: Vittoria nel Fermo e Lucia; il mutamento forse dettato dal gusto ironico, in quanto Perpetua è la protettrice delle donne coniugate.
70. sapeva... proprie: segna un legame di reciproca complementarità.
71. “Niente, niente”: evidente la sfasatura tra il comportamento e il linguaggio di don Abbondio; il dialogo è costruito tra la curiosità di Perpetua, tinta di formule suadenti e ricattatorie, e la reticenza del curato, adoperata anche come sceneggiata per alludere, nel silenzio, al suo isolato e grave stato ed orchestrata perciò come segnale di necessità di conforto e consolazione. Il giocare dei due personaggi con il bicchiere di vino dà ulteriore rilevanza teatrale e comica alla scena. 
72. come quando...: nel Fermo e Lucia vi era accennato uno specifico episodio; molto più efficace l’accenno indeterminato.
73. arcivescovo: Federico Borromeo, arcivescovo di Milano. Il parere di Perpetua manca nel Fermo e Lucia; la sua introduzione serve a irrobustire il personaggio e a contrapporlo al suo padrone; inoltre introduce il personaggio del Cardinale, come punto di riferimento degli umili e del popolo.
74. ci gongola: espressione di soddisfazione popolana per la sconfitta dei prepotenti attribuita all’arcivescovo.